傌	㐷 骂
㑶	㐹
偑	㐽
㑳	㑇
倲	㑈
㑯	㑔
儸	㑩
𠗣	㓆
劏	㓥
劚	㔉
噚	㖊
喎	㖞
㘚	㘎
㜄	㚯
媰	㛀
𡞵	㛟
𡢃	㛠
㜏	㛣
孋	㛤
𡠹	㛿
㠏	㟆
𡾱	㟜
嵾	㟥
幓	㡎
㥮	㤘
懤	㤽
慺	㥪
掆	㧏
㩳	㧐
撝	㧑
擓	㧟
擽	㧰
㩜	㨫
棡	㭎
椲	㭏
𣙎	㭣
樢	㭤
樫	㭴
殰	㱩
殨	㱮
瀇	㲿
濧	㳔
灡	㳕
澾	㳠
濄	㳡
𣾷	㳢
潚	㴋
鸂	㶉
燶	㶶
煱	㶽
獱	㺍
璯	㻅
𤫩	㻏
𤪺	㻘
䁻	䀥
瞜	䁖
碽	䂵
磾	䃅
稏	䅉
穇	䅟
𥢢	䅪
籔	䉤
䊷	䌶
縳	䌸
絅	䌹
䋙	䌺
䋚	䌻
綐	䌼
䋻	䌾
䋹	䌿
繿	䍀
繸	䍁
䍦	䍠
䎱	䎬
膞	䏝
𦪙	䑽
薵	䓓
薳	䓕
藭	䓖
罃	䓨
螮	䗖
𧝞	䘛
𧜗	䘞
𧜵	䙊
䙡	䙌
訢	䜣 欣
鿁	䜤
𧩙	䜥
䜀	䜧
讌	䜩 宴
貙	䝙
𧵳	䞌
䝼	䞍
𧶧	䞎
賰	䞐
躎	䟢
𨊰	䢀
𨊸	䢁
𨋢	䢂
釾	䥺
鏺	䥽
䥱	䥾
𨯅	䥿
𨦫	䦀
𨧜	䦁
䥇	䦂
鐯	䦃
鐥	䦅
䦛	䦶
䦟	䦷
𩞯	䭪
𩣑	䯃
騧	䯄
䯀	䯅
䱽	䲝
𩶘	䲞
鮣	䲟
鰆	䲠
鰌	䲡 鳅
鰧	䲢
䱷	䲣
鳾	䴓
鵁	䴔
鴷	䴕
鶄	䴖
鶪	䴗
鷉	䴘
鸊	䴙
龑	䶮
萬	万
與	与
匃	丐
匄	丐
醜	丑
專	专
耑	专
坵	丘
業	业
叢	丛
東	东
絲	丝
丟	丢
兩	两
嚴	严
喪	丧
個	个
箇	个
枒	丫
豐	丰
臨	临
為	为
爲	为
麗	丽
擧	举
舉	举
廼	乃
迺	乃
麼	么 麽
麽	么 麽
義	义
烏	乌
樂	乐
喬	乔
乗	乘
椉	乘
習	习
鄉	乡
書	书
買	买
亂	乱
爭	争
於	于 於
虧	亏
雲	云
亙	亘
亞	亚
亾	亡
產	产
産	产
畂	亩
畆	亩
畝	亩
畮	亩
𤰜	亩
𤱈	亩
亯	享
親	亲
褻	亵
嚲	亸
億	亿
僅	仅
僕	仆
讎	仇 雠
讐	仇 雠
從	从
侖	仑
崘	仑
崙	仑
倉	仓
僊	仙
㕥	以
㠯	以
儀	仪
們	们
價	价
倣	仿
髣	仿
眾	众
衆	众
優	优
夥	伙 夥
會	会
傴	伛
傘	伞
繖	伞
𠌂	伞
偉	伟
傳	传
俥	伡
俔	伣
傷	伤
倀	伥
倫	伦
傖	伧
偽	伪
僞	伪
佇	伫
竚	伫 𥩟
佀	似
體	体
餘	余
彿	佛
髴	佛
妳	你 妳 奶
傭	佣
僉	佥
偘	侃
妷	侄
姪	侄
俠	侠
侶	侣
僥	侥
儌	侥
偵	侦
遉	侦
側	侧
僑	侨
儈	侩
儕	侪
儂	侬
㑺	俊
儁	俊
竢	俟
俁	俣
儔	俦
儼	俨
倆	俩
儷	俪
倈	俫
儉	俭
脩	修 脩
俛	俯
頫	俯 𫖯
倐	倏
儵	倏
勌	倦
債	债
傾	倾
叚	假
傯	偬
媮	偷
僂	偻
僨	偾
償	偿
儎	傤
儻	傥
儐	傧
儲	储
儺	傩
殭	僵
兒	儿
剋	克 剋
尅	克 剋
兌	兑
兎	兔
兔	兔
兗	兖
黨	党
兠	兜
蘭	兰
關	关
興	兴
茲	兹
養	养
獸	兽
囅	冁
內	内
岡	冈
冄	冉
冊	册
𠕂	再
𠕅	再
冐	冒
宂	冗
寫	写
軍	军
農	农
辳	农
塚	冢
寃	冤
𡨘	冤
㝠	冥
𠖇	冥
鼕	冬
馮	冯
氷	冰
沖	冲
衝	冲
決	决
況	况
凍	冻
凈	净
淨	净
悽	凄
淒	凄
準	准
涼	凉
淩	凌
減	减
湊	凑
凜	凛
幾	几
凢	凡
鳳	凤
鳧	凫
鳬	凫
凴	凭
憑	凭
凱	凯
櫈	凳
兇	凶
齣	出
擊	击
圅	函
鑿	凿
栞	刊
芻	刍
劃	划
劉	刘
則	则
剛	刚
剏	创
剙	创
創	创
刪	删
鉋	刨 铇
鑤	刨
別	别
彆	别
剗	刬
剄	刭
颳	刮
製	制
劵	券
剎	刹
劊	刽
㓨	刾
劌	刿
剴	剀
劑	剂
鬀	剃
剮	剐
劍	剑
劒	剑
剝	剥
劇	剧
賸	剩
勦	剿
𠞰	剿
勸	劝
辦	办
務	务
勱	劢
働	动
動	动
刦	劫
刧	劫
刼	劫
勵	励
勁	劲
勞	劳
勢	势
勛	勋
勳	勋
勗	勖
勩	勚
懃	勤
勻	匀
怱	匆
悤	匆
帀	匝
匭	匦
匱	匮
疋	匹
區	区
醫	医
韆	千
昇	升
陞	升
華	华
協	协
䘚	卒
單	单
賣	卖
愽	博
蔔	卜
佔	占
盧	卢
滷	卤
鹵	卤
臥	卧
衛	卫
巵	卮
夘	卯
戼	卯
卽	即
㕁	却
卻	却
捲	卷
巹	卺
廠	厂
戹	厄
阨	厄
廳	厅
厤	历
曆	历
歴	历
歷	历
𠪱	历
厲	厉
壓	压
厭	厌
厙	厍
龎	厐
厠	厕
廁	厕
釐	厘
廂	厢
厴	厣
廈	厦
㕑	厨
廚	厨
廄	厩
廐	厩
廝	厮
縣	县
叄	叁
㕘	参
參	参
葠	参
蓡	参
蔘	参
靉	叆
靆	叇
雙	双
發	发
髮	发
變	变
敍	叙
敘	叙
㬪	叠
曡	叠
疊	叠
敂	叩
秖	只
隻	只
呌	叫
檯	台
臺	台
颱	台
葉	叶
號	号
嘆	叹
歎	叹
嘰	叽
籲	吁
喫	吃
閤	合
弔	吊
仝	同
衕	同
後	后
嚮	向
曏	向
嚇	吓
呂	吕
嗎	吗
恡	吝
唫	吟
噸	吨
聽	听
唘	启
啓	启
啟	启
吳	吴
脗	吻
獃	呆
吶	呐
嘸	呒
囈	呓
嘔	呕
嚦	呖
唄	呗
員	员
咼	呙
嗆	呛
嗚	呜
週	周
嘑	呼
虖	呼
謼	呼
𠇮	命
咊	和
龢	和
詠	咏
呪	咒
嚨	咙
嚀	咛
噝	咝
吒	咤 吒
諮	咨 谘
哶	咩
𠴟	咩
齩	咬 𫜪
倃	咱
偺	咱
喒	咱
𠴰	咱
欬	咳
鹹	咸
嚥	咽
吚	咿
閧	哄
鬨	哄
響	响
啞	哑
噠	哒
嘵	哓
嗶	哔
噦	哕
嘩	哗
譁	哗
噲	哙
嚌	哜
噥	哝
喲	哟
喆	哲
脣	唇
嘜	唛
嗊	唝
嘮	唠
啢	唡
嗩	唢
唕	唣
喚	唤
啗	啖
噉	啖
嘖	啧
嗇	啬
囀	啭
嚙	啮
囓	啮
齧	啮
嘓	啯
囉	啰
嘽	啴
嘯	啸
嗁	啼
餧	喂 𫗪
餵	喂
啑	喋
瘖	喑
諠	喧
噴	喷
嘍	喽
嚳	喾
嘷	嗥
獋	嗥
囁	嗫
噯	嗳
𠻳	嗽
嘠	嘎
噓	嘘
嚶	嘤
囑	嘱
譆	嘻 𫍻
嚕	噜
譟	噪
囂	嚣
廻	回
迴	回
逥	回
囙	因
團	团
糰	团
園	园
睏	困
囪	囱
圍	围
圇	囵
國	国
圖	图
圓	圆
聖	圣
壙	圹
場	场
塲	场
阯	址
岅	坂
埳	坎
壞	坏
阬	坑
塊	块
堅	坚
墰	坛
壇	坛
壜	坛
罈	坛
罎	坛
壢	坜
垻	坝
壩	坝
塢	坞
隖	坞
墳	坟
墜	坠
堃	坤
㘭	坳
壟	垄
壠	垅
壚	垆
壘	垒
垜	垛
墾	垦
堊	垩
墊	垫
埡	垭
墶	垯
壋	垱
塏	垲
堖	垴
塒	埘
塤	埙
壎	埙
堝	埚
碕	埼
塹	堑
墮	堕
陻	堙
隄	堤
壪	塆
堘	塍
墖	塔
墻	墙
牆	墙
墪	墩
壯	壮
聲	声
殻	壳
殼	壳
壺	壶
壼	壸
處	处
俻	备
備	备
復	复
複	复
亱	夜
夠	够
殀	夭
頭	头
誇	夸
夾	夹
袷	夹
裌	夹
奪	夺
匲	奁
匳	奁
奩	奁
籨	奁
奐	奂
奮	奋
犇	奔
逩	奔
奔	奔
奬	奖
獎	奖
奧	奥
嬭	奶
姦	奸
妝	妆
粧	妆
婦	妇
媍	妇
媽	妈
姙	妊
妬	妒
玅	妙
嫵	妩
嫗	妪
媯	妫
嬀	妫
姉	姊
姍	姗
薑	姜
奼	姹
婣	姻
婁	娄
婭	娅
嬈	娆
嬌	娇
孌	娈
孃	娘
娛	娱
媧	娲
嫺	娴
嫻	娴
娿	婀
惏	婪
嫿	婳
嬰	婴
嬋	婵
嬸	婶
壻	婿
媼	媪
嬃	媭
嬡	嫒
嬪	嫔
嫰	嫩
嬙	嫱
嬤	嬷
孫	孙
學	学
孿	孪
孼	孽
寕	宁
寧	宁
甯	宁
牠	它
寳	宝
寶	宝
寔	实
實	实
寵	宠
審	审
憲	宪
宮	宫
醼	宴
傢	家
寬	宽
賓	宾
㝛	宿
𡨥	寇
𭁵	寇
庽	寓
寑	寝
寢	寝
詧	察
砦	寨
對	对
尋	寻
𡬶	寻
導	导
壽	寿
䠶	射
將	将
尒	尔
爾	尔
塵	尘
尙	尚
嘗	尝
嚐	尝
甞	尝
堯	尧
尷	尴
屍	尸
儘	尽
盡	尽
侷	局
跼	局
層	层
屓	屃
屜	屉
屆	届
屛	屏
屬	属
屢	屡
屨	屦
嶼	屿
嵗	岁
歲	岁
𡻕	岁
豈	岂
嶇	岖
崗	岗
峴	岘
嵐	岚
㠀	岛
島	岛
嵒	岩
巖	岩
巗	岩 𪨷
嶺	岭
嶽	岳
㟁	岸
崬	岽
巋	岿
嶨	峃
嶧	峄
峝	峒
峽	峡
嶢	峣
嶠	峤
崢	峥
巒	峦
峩	峨
陗	峭
峯	峰
嶗	崂
崍	崃
嶮	崄
嶃	崭
嶄	崭
嶸	嵘
嶔	嵚
嶁	嵝
巔	巅
廵	巡
鉅	巨 钜
鞏	巩
巰	巯
幣	币
佈	布
帥	帅
㠶	帆
颿	帆
師	师
幃	帏
帳	帐 账
簾	帘
袟	帙
袠	帙
箒	帚
幟	帜
帶	带
幀	帧
蓆	席
幇	帮
幚	帮
幫	帮
幬	帱
幘	帻
幗	帼
㡌	帽
冪	幂
幙	幕
乹	干
乾	干 乾
亁	干
幹	干
榦	干
秊	年
並	并
併	并
竝	并
倖	幸
廣	广
莊	庄
慶	庆
牀	床
廬	庐
廡	庑
庫	库
應	应
廟	庙
龐	庞
廢	废
癈	废
菴	庵
庻	庶
廎	庼
㢘	廉
亷	廉
廩	廪
開	开
異	异
棄	弃
挵	弄
衖	弄
𡚁	弊
弒	弑
張	张
彌	弥
瀰	弥
絃	弦
弳	弪
彎	弯
彈	弹
強	强
彊	强
歸	归
噹	当
當	当
彔	录
錄	录
録	录
彞	彝
彠	彟
彥	彦
彲	彨
綵	彩
彷	彷 仿
徹	彻
徃	往
徵	征 徵
徑	径
狥	徇
徠	徕
禦	御
惪	德
幑	徽
憶	忆
懺	忏
誌	志
啎	忤
憂	忧
唸	念
愾	忾
懷	怀
態	态
慫	怂
憮	怃
慪	怄
悵	怅
愴	怆
憐	怜
恠	怪
總	总
懟	怼
懌	怿
戀	恋
怳	恍
恆	恒
䘏	恤
卹	恤
賉	恤
㤙	恩
懇	恳
噁	恶 𫫇
惡	恶
慟	恸
懨	恹
愷	恺
惻	恻
惱	恼
惲	恽
惥	恿
慂	恿
猂	悍
誖	悖
悅	悦
愨	悫
慤	悫
懸	悬
慳	悭
悞	悮
憫	悯
顇	悴
㥫	惇
驚	惊
懼	惧
慘	惨
懲	惩
憊	惫
㥦	惬
愜	惬
慙	惭
慚	惭
憚	惮
慣	惯
諐	愆
瘉	愈
癒	愈
慍	愠
憤	愤
憒	愦
媿	愧
願	愿
昚	慎
慴	慑
懾	慑
嘅	慨
憖	慭
癄	憔
顦	憔
憇	憩
懣	懑
嬾	懒
懶	懒
懍	懔
戇	戆
戔	戋
戲	戏
戧	戗
戰	战
慼	戚
慽	戚
戞	戛
戩	戬
剹	戮
戱	戯
戶	户
纔	才
紥	扎
紮	扎
撲	扑
託	托
摃	扛
釦	扣
執	执
擴	扩
捫	扪
掃	扫
揚	扬
敭	扬
颺	扬 飏
撦	扯
擾	扰
搤	扼
摺	折
撫	抚
拋	抛
摶	抟
摳	抠
掄	抡
搶	抢
護	护
報	报
觝	抵
擔	担
枴	拐
柺	拐
搨	拓
拕	拖
抝	拗
儗	拟
擬	拟
攏	拢
揀	拣
擁	拥
攔	拦
擰	拧
撥	拨
擇	择
𢬸	括
拚	拼
㧱	拿
拏	拿
挐	拿
掛	挂
𦊱	挂
摯	挚
攣	挛
掗	挜
撾	挝
撻	挞
挾	挟
撓	挠
擋	挡
攩	挡
撟	挢
掙	挣
擠	挤
揮	挥
撏	挦
捱	挨
挱	挲
輓	挽
摀	捂
綑	捆
扞	捍 扞
揑	捏
挩	捝
撈	捞
損	损
撿	捡
換	换
搗	捣
擣	捣
𢷬	捣
㨿	据
據	据
搥	捶
㨗	捷
搯	掏
擄	掳
摑	掴
擲	掷
撣	掸
摻	掺
摜	掼
揷	插
揫	揪
攬	揽
搵	揾
搇	揿
撳	揿
攙	搀 掺
擱	搁
摟	搂
揯	搄
攪	搅
蒐	搜 蒐
㩗	携
㩦	携
擕	携
攜	携
攝	摄
攄	摅
擺	摆
襬	摆
搖	摇
擯	摈
攤	摊
攖	撄
撐	撑
譔	撰
攆	撵
擷	撷
擼	撸
攛	撺
𢮥	操
㩵	擜
擻	擞
攢	攒
傚	效
効	效
敵	敌
捄	救
勅	敕
勑	敕 𠡠
敎	教
敓	敚
斂	敛
歛	敛
㪚	散
㪟	敦
斆	敩
數	数
亝	斋
齋	斋
斕	斓
鬥	斗
鬦	斗
鬪	斗
鬭	斗
觔	斤
斬	斩
斮	斫
斲	斫
斵	斫
斷	断
鏇	旋
旂	旗
無	无
旣	既
舊	旧
旹	时
時	时
曠	旷
暘	旸
崐	昆
崑	昆
昬	昏
曇	昙
暎	映
旾	春
昰	是
暱	昵
晝	昼
曨	昽
顯	显
㨪	晃
晉	晋
曬	晒
曉	晓
曄	晔
暈	晕
暉	晖
晳	晰
暫	暂
蹔	暂 𫏐
𣈶	暅
㬉	暖
煖	暖
煗	暖
晻	暗
闇	暗
曖	暧
麯	曲
麴	曲 麹
㝡	最
冣	最
朢	望
朞	期
剳	札
劄	札 劄
朮	术
術	术
硃	朱
樸	朴
朶	朵
機	机
殺	杀
襍	杂
雜	杂
權	权
桿	杆
邨	村
槓	杠
條	条
來	来
楊	杨
榪	杩
桮	杯
盃	杯
傑	杰
鬆	松
闆	板
極	极
搆	构
構	构
菓	果
樅	枞
樞	枢
棗	枣
櫪	枥
梘	枧
棖	枨
槍	枪
鎗	枪
楓	枫
梟	枭
栢	柏
櫃	柜
檸	柠
査	查
栁	柳
桺	柳
檉	柽
柹	柿
梔	栀
柵	栅
標	标
棧	栈
櫛	栉
櫳	栊
棟	栋
櫨	栌
櫟	栎
欄	栏
樹	树
棲	栖
慄	栗
樣	样
覈	核
欒	栾
槕	桌
桒	桑
椏	桠 丫
橈	桡
楨	桢
檔	档
榿	桤
橋	桥
樺	桦
檜	桧
槳	桨
樁	桩
樳	桪
樑	梁
楳	梅
槑	梅
夢	梦
棃	梨
檮	梼
棶	梾
槤	梿
檢	检
梲	棁
欞	棂
棊	棋
碁	棋
椶	棕
箠	棰
稜	棱
櫂	棹
槨	椁
櫝	椟
槧	椠
槶	椢
欏	椤
樿	椫
橢	椭
槮	椮
枏	楠
柟	楠
楥	楦
檝	楫
樓	楼
㮣	概
欖	榄
榲	榅
櫬	榇
櫚	榈
櫸	榉
欅	榉
牓	榜
樧	榝
搾	榨
搉	榷
𣙜	榷
槀	槁
檟	槚
檻	槛
檳	槟
櫧	槠
橫	横
檣	樯
艢	樯
櫻	樱
罇	樽
橜	橛
櫫	橥
櫥	橱
㯭	橹
樐	橹
櫓	橹
艣	橹 𫇛
艪	橹
櫞	橼
簷	檐
檁	檩
懽	欢
歡	欢
讙	欢
驩	欢
歟	欤
歐	欧
慾	欲
欵	款
謌	歌
殲	歼
歿	殁
殤	殇
殘	残
殞	殒
殮	殓
殫	殚
殯	殡
毆	殴
慇	殷
毀	毁
燬	毁
譭	毁
轂	毂
畢	毕
毘	毗
斃	毙
獘	毙
氈	毡
氊	毡
毿	毵
𣯶	毶
氌	氇
氣	气
雰	氛
氫	氢
氬	氩
氳	氲
匯	汇
彙	汇
滙	汇
漢	汉
汙	污
汚	污
湯	汤
洶	汹
澐	沄
沈	沈 沉
瀋	沈
溝	沟
沒	没
灃	沣
漚	沤
瀝	沥
淪	沦
滄	沧
渢	沨
溈	沩
潙	沩
滬	沪
霑	沾
洩	泄
㳒	法
灋	法
氾	泛
汎	泛
濘	泞
註	注
淚	泪
冺	泯
澩	泶
瀧	泷
瀘	泸
濼	泺
瀉	泻
潑	泼
澤	泽
涇	泾
潔	洁
絜	洁
灑	洒
窪	洼
浹	浃
淺	浅
漿	浆
澆	浇
湞	浈
溮	浉
濁	浊
測	测
澮	浍
濟	济
瀏	浏
滻	浐
渾	浑
滸	浒
濃	浓
潯	浔
濜	浕
淛	浙
濬	浚
澣	浣
塗	涂
湼	涅
湧	涌
㳄	涎
涗	涚
濤	涛
澇	涝
淶	涞
漣	涟
潿	涠
渦	涡
溳	涢
渙	涣
滌	涤
潤	润
澗	涧
漲	涨
澀	涩
澁	涩
濇	涩
澱	淀
殽	淆
痳	淋 麻 痳
澹	淡
婬	淫
滛	淫
㴱	深
湻	淳
淵	渊
淥	渌
漬	渍
瀆	渎
漸	渐
澠	渑
漁	渔
滲	渗
溫	温
遊	游
淼	渺
𣺌	渺
灣	湾
溼	湿
濕	湿
濚	溁
潰	溃
濺	溅
漵	溆
漊	溇
谿	溪
泝	溯
遡	溯
潷	滗
滾	滚
滯	滞
灧	滟
灩	滟
灄	滠
滿	满
瀅	滢
濾	滤
濫	滥
灤	滦
濱	滨
灘	滩
澦	滪
灕	漓
潄	漱
瀠	潆
瀟	潇
瀲	潋
濰	潍
潛	潜
潀	潨
瀦	潴
澂	澄
瀂	澛
瀾	澜
瀨	濑
瀕	濒
濛	濛 蒙
灝	灏
滅	灭
燈	灯
靈	灵
竈	灶
災	灾
烖	灾
菑	灾
燦	灿
煬	炀
爐	炉
鑪	炉 𬬻
匟	炕
燉	炖
煒	炜
熗	炝
砲	炮
礮	炮 𪿫
烱	炯
點	点
煉	炼
鍊	炼 链 𫔀
熾	炽
爍	烁
爛	烂
烴	烃
燭	烛
煙	烟
菸	烟
煩	烦
燒	烧
燁	烨
爗	烨
燴	烩
燙	烫
燼	烬
熱	热
釬	焊
銲	焊
煥	焕
燜	焖
燾	焘
燄	焰
炤	照
煑	煮
熅	煴
燻	熏
熈	熙
𤋮	熙
鷰	燕
爕	燮
愛	爱
爺	爷
牘	牍
氂	牦
犛	牦
牴	牴 抵
牽	牵
犧	牺
犂	犁
犢	犊
狀	状
獷	犷
獁	犸
猶	犹
狽	狈
獮	狝
獰	狞
獨	独
狹	狭
陿	狭
獅	狮
獪	狯
猙	狰
獄	狱
猻	狲
獧	狷
貍	狸
獫	猃
獵	猎
獼	猕
玀	猡
豬	猪
貓	猫
蝟	猬
獻	献
猨	猿
蝯	猿
麞	獐
獺	獭
䝔	獾
貛	獾
璣	玑
璵	玙
瑒	玚
瑪	玛
翫	玩
瑋	玮
環	环
現	现
瑲	玱
瑇	玳
璽	玺
珊	珊
珎	珍
琺	珐
瓏	珑
璫	珰
琿	珲
毬	球
瑯	琅
瑠	琉
璢	琉
璡	琎
璉	琏
瑣	琐
𤨏	琐
琹	琴
瓊	琼
瓌	瑰
瑤	瑶
璦	瑷
璸	瑸
琍	璃
瓈	璃
璿	璇
瓔	璎
瓚	瓒
甕	瓮
罋	瓮
甌	瓯
缾	瓶
電	电
畫	画 划
畵	画
暢	畅
㽞	留
畱	留
𤱊	留
畧	略
疇	畴
疎	疏
癤	疖
療	疗
瘧	疟
癘	疠
瘍	疡
癧	疬
瘲	疭
瘡	疮
瘋	疯
皰	疱
痾	疴
癥	症
癰	痈
痙	痉
癢	痒
瘂	痖
癆	痨
瘓	痪
癇	痫
疿	痱
癡	痴
痺	痹
癉	瘅
瘮	瘆
瘞	瘗
瘺	瘘
瘻	瘘
癅	瘤
𤺥	瘩
㿜	瘪
癟	瘪
癱	瘫
癮	瘾
癭	瘿
癩	癞
癬	癣
癲	癫
皁	皂
皐	皋
臯	皋
皚	皑
暠	皓
皜	皓
皺	皱
皸	皲
盇	盍
琖	盏
盞	盏
醆	盏
鹽	盐
監	监
蓋	盖
盜	盗
盤	盘
𦕈	眇
瞘	眍
眞	真
眥	眦
矓	眬
瞇	眯
睠	眷
覜	眺
著	着 著
睜	睁
睞	睐
瞼	睑
倸	睬
覩	睹
睪	睾
叡	睿
矁	瞅
𥄨	瞅
瞶	瞆
瞞	瞒
矚	瞩
瞭	瞭 了
矙	瞰
榘	矩
矯	矫
磯	矶
礬	矾
礦	矿
鑛	矿
碭	砀
碼	码
塼	砖
甎	砖
磚	砖
硨	砗
硯	砚
碸	砜
碪	砧
礪	砺
礱	砻
礫	砾
礎	础
硜	硁
碩	硕
硤	硖
磽	硗
磑	硙
礄	硚
確	确
磠	硵
礆	硷
椗	碇
矴	碇
磟	碌
礙	碍
㼝	碗
椀	碗
盌	碗
磧	碛
磣	碜
掽	碰
踫	碰
堿	碱
鹻	碱
鹼	碱
𦉆	碴
燐	磷
粦	磷
禮	礼
禩	祀
禡	祃
祇	祇 只
禕	祎
禰	祢
禎	祯
禱	祷
旤	祸
禍	祸
稟	禀
祿	禄
禪	禅
離	离
俬	私
禿	秃
稈	秆
秌	秋
鞦	秋
𥤚	秋
種	种
粃	秕
祕	秘
積	积
稱	称
稭	秸
迻	移
穢	秽
穠	秾
稅	税
粺	稗
稺	稚
穉	稚
穌	稣
穩	稳
稾	稿
穡	穑
穭	穞
窮	穷
竊	窃
竅	窍
窵	窎
窯	窑
窰	窑
牎	窗
牕	窗
窓	窗
窻	窗
𥦗	窗
竄	窜
窩	窝
窺	窥
闚	窥
竇	窦
窶	窭
竪	竖
豎	竖
競	竞
篤	笃
筍	笋
咲	笑
筆	笔
筧	笕
椾	笺
牋	笺
箋	笺
籠	笼
籩	笾
栰	筏
築	筑
筩	筒
筞	策
筴	策
篳	筚
篩	筛
簹	筜
箏	筝
䈰	筲
籌	筹
篔	筼
簽	签
籤	签
篠	筿
簡	简
籙	箓
筦	管
簀	箦
篋	箧
籜	箨
籮	箩
簞	箪
簫	箫
篛	箬
筯	箸
簣	篑
簍	篓
簒	篡
籃	篮
籛	篯
籬	篱
籪	簖
簮	簪
籟	籁
糴	籴
類	类
秈	籼
觕	粗
麤	粗
糶	粜
糲	粝
粵	粤
糞	粪
糧	粮
秔	粳
稉	粳
糉	粽
糝	糁
餱	糇
䊀	糊
餬	糊
餈	糍
餻	糕
醣	糖
餹	糖
蹧	糟
穅	糠
粇	糠
稬	糯
穤	糯
係	系
繫	系
緊	紧
𦂳	紧
𦃂	紧
纍	累
縶	絷
緐	繁
𥲻	纂
糹	纟
糺	纠 𫄙
糾	纠
紆	纡
紅	红
紂	纣
縴	纤
纖	纤
紇	纥
約	约
級	级
紈	纨
纊	纩
紀	纪
紉	纫
緯	纬
紜	纭
紘	纮
純	纯
紕	纰
紗	纱
綱	纲
納	纳
紝	纴
縱	纵
綸	纶
紛	纷
帋	纸
紙	纸
紋	纹
紡	纺
紵	纻
紖	纼
紐	纽
紓	纾
綫	线
線	线 缐
紺	绀
紲	绁
絏	绁
紱	绂
練	练
組	组
紳	绅
細	细
織	织
終	终
縐	绉
絆	绊
紼	绋
絀	绌
紹	绍
繹	绎
經	经
紿	绐
綁	绑
毧	绒
絨	绒
羢	绒
結	结
絝	绔
繞	绕
遶	绕
絰	绖
絎	绗
繪	绘
給	给
絢	绚
絳	绛
絡	络
絕	绝
絶	绝
絞	绞
統	统
綆	绠
綃	绡
絹	绢
綉	绣
繡	绣
綌	绤
綏	绥
絛	绦
縚	绦
縧	绦
繼	继
綈	绨
勣	绩 𪟝
績	绩
緒	绪
綾	绫
緓	绬
續	续
綺	绮
緋	绯
綽	绰
緔	绱
鞝	绱
緄	绲
繩	绳
維	维
綿	绵
緜	绵
綬	绶
綳	绷
繃	绷
紬	绸 䌷
綢	绸
綯	绹
綹	绺
綣	绻
綜	综
綻	绽
綰	绾
綠	绿
緑	绿
菉	绿
綴	缀
緇	缁
緙	缂
緗	缃
椷	缄
緘	缄
緬	缅
纜	缆
緹	缇
緲	缈
緝	缉
緼	缊
縕	缊
繢	缋
緦	缌
綞	缍
緞	缎
緶	缏
緱	缑
縋	缒
緩	缓
締	缔
縷	缕
編	编
緡	缗
緣	缘
縉	缙
縛	缚
縟	缛
縝	缜
縫	缝
縗	缞
縞	缟
纏	缠
縭	缡
縊	缢
縑	缣
繽	缤
縹	缥
縵	缦
縲	缧
纓	缨
縮	缩
繆	缪
繅	缫
纈	缬
繚	缭
繕	缮
繒	缯
繮	缰
韁	缰
繾	缱
繰	缲
繯	缳
繳	缴
纘	缵
甖	罂
罌	罂
鑵	罐
網	网
㒺	罔
羅	罗
罰	罚
罸	罚
罷	罢
辠	罪
寘	置
羆	罴
羈	羁
覊	羁
羗	羌
𦍑	羌
羥	羟
羨	羡
羣	群
翄	翅
翹	翘
翽	翙
翬	翚
翺	翱
瞖	翳
繙	翻
飜	翻
燿	耀
攷	考
畊	耕
耮	耢
耬	耧
聳	耸
恥	耻
躭	耽
聶	聂
聾	聋
職	职
聹	聍
聯	联
聵	聩
聰	聪
肅	肃
疘	肛
腸	肠
膓	肠
膚	肤
骯	肮
肎	肯
餚	肴
腎	肾
腫	肿
脹	胀
脅	胁
脇	胁
冑	胄
膽	胆
揹	背
肧	胚
勝	胜
衚	胡
鬍	胡
朧	胧
腖	胨
臚	胪
脛	胫
踁	胫
臙	胭
肐	胳
膠	胶
胷	胸
脃	脆
䘑	脉
脈	脉
衇	脉
膾	脍
臟	脏
髒	脏
臍	脐
腦	脑
膿	脓
臠	脔
𩓐	脖
腳	脚
脫	脱
腡	脶
臉	脸
臈	腊
臘	腊
醃	腌
膕	腘
齶	腭
顋	腮
膩	腻
靦	腼
膃	腽
騰	腾
骽	腿
髈	膀
臏	膑
臕	膘
厀	膝
饍	膳
羴	膻
羶	膻
臋	臀
臢	臜
緻	致
輿	舆
捨	舍
艤	舣
艦	舰
艙	舱
舩	船
艫	舻
艱	艰
艷	艳
豓	艳
豔	艳
藝	艺
節	节
羋	芈
薌	芗
蕪	芜
蘆	芦
芲	花
蘤	花
蕓	芸
蓯	苁
葦	苇
藶	苈
莧	苋
萇	苌
蒼	苍
苧	苎
囌	苏
甦	苏
蘇	苏
蘓	苏
薹	苔
薴	苧
範	范
莖	茎
蘢	茏
蔦	茑
塋	茔
煢	茕
繭	茧
蠒	茧
荊	荆
艸	草
薦	荐
茘	荔
薘	荙
莢	荚
蕘	荛
蓽	荜
萴	荝
荍	荞
蕎	荞
薈	荟
薺	荠
盪	荡
蕩	荡
榮	荣
葷	荤
滎	荥
犖	荦
熒	荧
蕁	荨
藎	荩
蓀	荪
廕	荫
蔭	荫
蕒	荬
葒	荭
葤	荮
葯	药
藥	药
涖	莅
蒞	莅
萊	莱
蓮	莲
蒔	莳
萵	莴
薟	莶
獲	获
穫	获
蕕	莸
瑩	莹
鶯	莺
鸎	莺
蒓	莼
蓴	莼
蔆	菱
蘀	萚
蘿	萝
螢	萤
營	营
縈	萦
蕭	萧
薩	萨
萲	萱
蕿	萱
藼	萱
蘐	萱
蕚	萼
塟	葬
𦵏	葬
蔥	葱
蒕	蒀
蔕	蒂
蕆	蒇
蕢	蒉
蔣	蒋
蔞	蒌
醟	蒏
懞	蒙
矇	蒙
簑	蓑
藍	蓝
薊	蓟
蘺	蓠
蕷	蓣
鎣	蓥
驀	蓦
虆	蔂
衊	蔑
薔	蔷
蘞	蔹
藺	蔺
藹	蔼
橤	蕊
蕋	蕊
蘂	蕊
薀	蕰
蘄	蕲
藴	蕴
蘊	蕴
薙	薙 剃
藪	薮
藷	薯 𫉄
藉	藉 借
蘚	藓
蔾	藜
籐	藤
櫱	蘖
虜	虏
虜	虏
慮	虑
虛	虚
蟲	虫
虯	虬
蟣	虮
蝨	虱
蝱	虻
雖	虽
蝦	虾
蠆	虿
蝕	蚀
蟻	蚁
螞	蚂
蠁	蚃
螡	蚊
蟁	蚊
蠶	蚕
蠔	蚝
蜆	蚬
虵	蛇
蠱	蛊
蠣	蛎
蟶	蛏
痐	蛔
蚘	蛔
蛕	蛔
蜖	蛔
鼃	蛙
蠻	蛮
蟄	蛰
蛺	蛱
蟯	蛲
螄	蛳
蠐	蛴
䗬	蜂
蠭	蜂
蛻	蜕
蝸	蜗
蠟	蜡
蠅	蝇
蟈	蝈
蟬	蝉
蠍	蝎
蜨	蝶
螻	蝼
蠑	蝾
螿	螀
蜋	螂
螎	融
蟎	螨
蟇	蟆
蠨	蟏
蠏	蟹
蝡	蠕
惷	蠢
䶊	衄
衂	衄
釁	衅
啣	衔
衘	衔
銜	衔
補	补
錶	表
襯	衬
袞	衮
衹	衹 只
袵	衽
襖	袄
嫋	袅
嬝	袅
裊	袅
褭	袅
褘	袆
襢	袒
襪	袜
韈	袜
韤	袜
襲	袭
襏	袯
裝	装
襠	裆
褌	裈
帬	裙
裠	裙
褳	裢
襝	裣
袴	裤
褲	裤
襇	裥
襉	裥
臝	裸
躶	裸
襃	褒
緥	褓
褸	褛
襤	褴
繦	襁
襴	襕
覆	覆 复
見	见
觀	观
覎	觃
槼	规 椝
規	规
覓	觅
覔	觅
眎	视
眡	视
視	视
覘	觇
覽	览
覺	觉
覬	觊
覡	觋
覿	觌
覥	觍
覦	觎
覯	觏
覲	觐
覷	觑
觴	觞
觸	触
觶	觯
誾	訚
讋	詟
譽	誉
謄	誊
訁	讠
計	计
訂	订
訃	讣
認	认
譏	讥
訐	讦
訌	讧
討	讨
讓	让
訕	讪
訖	讫
訓	训
議	议
訊	讯
記	记
訒	讱
講	讲
諱	讳
謳	讴
詎	讵
訝	讶
訥	讷
許	许
訛	讹
譌	讹
論	论
訩	讻
訟	讼
諷	讽
設	设
訪	访
訣	诀
証	证
證	证
詁	诂
訶	诃
評	评
詛	诅
識	识
詗	诇
詐	诈
愬	诉
訴	诉
診	诊
詆	诋
謅	诌
䛐	词
詞	词
詘	诎
詔	诏
詖	诐
譯	译
詒	诒
誆	诓
誄	诔
試	试
詿	诖
詩	诗
詰	诘
詼	诙
誠	诚
誅	诛
詵	诜
䛡	话
話	话
誕	诞
詬	诟
詮	诠
詭	诡
詢	询
詣	诣
諍	诤
該	该
詳	详
詫	诧
諢	诨
詡	诩
譸	诪
誡	诫
誣	诬
語	语
誚	诮
誤	误
誥	诰
誘	诱
誨	诲
誑	诳
說	说
説	说
誦	诵
誒	诶
請	请
諸	诸
諏	诹
諾	诺
讀	读
諑	诼
誹	诽
課	课
諉	诿
諛	谀
誰	谁
諗	谂
調	调
諂	谄
謟	谄
諒	谅
諄	谆
誶	谇
談	谈
讅	谉
誼	谊
謀	谋
諶	谌
諜	谍
謊	谎
諫	谏
諧	谐
謔	谑
謁	谒
謂	谓
諤	谔
諭	谕
諼	谖
讒	谗
諳	谙
諺	谚
諦	谛
謎	谜
諞	谝
諝	谞
謨	谟
謩	谟
讜	谠
謖	谡
謝	谢
謠	谣
謡	谣
謗	谤
諡	谥
謚	谥
謙	谦
謐	谧
謹	谨
謾	谩
謫	谪
讁	谪
謭	谫
謬	谬
譚	谭
譖	谮
譙	谯
讕	谰
譜	谱
譎	谲
讞	谳
譴	谴
譫	谵
讖	谶
穀	谷
荳	豆
豶	豮
貝	贝
貞	贞
負	负
貟	贠
貢	贡
財	财
責	责
賢	贤
敗	败
賬	账
貨	货
質	质
販	贩
貪	贪
貧	贫
貶	贬
購	购
貯	贮
貫	贯
貳	贰
賤	贱
賁	贲
貰	贳
貼	贴
貴	贵
貺	贶
貸	贷
貿	贸
費	费
賀	贺
貽	贻
賊	贼
贄	贽
賈	贾
賄	贿
貲	赀 资
賃	赁
賂	赂
贓	赃
贜	赃
資	资
賅	赅
贐	赆
賕	赇
賑	赈
賚	赉
賒	赊
賦	赋
賭	赌
賫	赍
賷	赍
齎	赍
贖	赎
賞	赏
賜	赐
贔	赑
賙	赒
賡	赓
賠	赔
賧	赕
賴	赖
頼	赖
賵	赗
贅	赘
賻	赙
賺	赚
賽	赛
賾	赜
贋	赝
贗	赝
讚	赞
賛	赞
贊	赞
贇	赟
贈	赠
贍	赡
贏	赢
灨	赣
贑	赣 𫎬
贛	赣
赬	赪
趙	赵
趕	赶
趂	趁
趨	趋
趲	趱
躉	趸
躍	跃
蹌	跄
蹠	跖
躒	跞
踐	践
躂	跶
蹺	跷
蹻	跷 𫏋
蹕	跸
躚	跹
跥	跺
躋	跻
踴	踊
躊	踌
跴	踩
蹤	踪
躓	踬
躑	踯
蹏	蹄
躡	蹑
蹣	蹒
䠀	蹚
躕	蹰
蹵	蹴
躥	蹿
躪	躏
躦	躜
躳	躬
軀	躯
車	车
軋	轧
軌	轨
軒	轩
軑	轪
軔	轫
軔	轫
轉	转
軛	轭
輪	轮
軟	软
輭	软
轟	轰
軲	轱
軻	轲
轤	轳
軸	轴
軹	轵
軼	轶
軤	轷
軫	轸
轢	轹
軺	轺
輕	轻
軾	轼
載	载
輊	轾
轎	轿
輈	辀
輇	辁
輅	辂
較	较
輒	辄
輙	辄
輔	辅
輛	辆
輦	辇
輩	辈
煇	辉 𪸩
輝	辉
輥	辊
輞	辋
輬	辌
輟	辍
輜	辎
輳	辏
輻	辐
輯	辑
輼	辒
轀	辒
輸	输
轡	辔
轅	辕
轄	辖
輾	辗
轆	辘
轍	辙
轔	辚
辤	辞
辭	辞
闢	辟
辢	辣
辯	辩
辮	辫
邊	边
遼	辽
達	达
遷	迁
過	过
邁	迈
運	运
還	还
這	这
進	进
遠	远
違	违
連	连
遲	迟
逈	迥
邇	迩
廹	迫
逕	迳 径
跡	迹
蹟	迹
適	适
選	选
遜	逊
遞	递
邐	逦
邏	逻
偪	逼
踰	逾
遯	遁
徧	遍
遺	遗
遙	遥
鄧	邓
鄺	邝
衺	邪
鄔	邬
郵	邮
鄒	邹
鄴	邺
鄰	邻
隣	邻
欝	郁
鬰	郁
鬱	郁
郟	郏
鄶	郐
鄭	郑
鄆	郓
酈	郦
鄖	郧
鄲	郸
酇	酂
醖	酝
醞	酝
醱	酦
詶	酬
酧	酬
醻	酬
醬	酱
痠	酸
釅	酽
釃	酾
釀	酿
醕	醇
埰	采
寀	采
採	采
釋	释
裏	里
裡	里
埜	野
𡐨	野
鍳	鉴
鑑	鉴
鑒	鉴
鑾	銮
鏨	錾
釒	钅
釓	钆
釔	钇
針	针
鍼	针
釘	钉
釗	钊
釙	钋
釕	钌
釷	钍
釺	钎
釧	钏
釤	钐
鈒	钑
釩	钒
釣	钓
鍆	钔
釹	钕
鍚	钖
釵	钗
鈃	钘
鈣	钙
鈈	钚
鈦	钛
鈍	钝
鈔	钞
鈡	钟
鍾	钟 锺
鐘	钟
鈉	钠
鋇	钡
鋼	钢
鈑	钣
鈐	钤
鈅	钥
鑰	钥
欽	钦
鈞	钧
鎢	钨
鈎	钩
鉤	钩
鈧	钪
鈁	钫
鍅	钫
鈥	钬
鈄	钭
鈕	钮
鈀	钯
鈺	钰
錢	钱
鉦	钲
鉗	钳
鈷	钴
盋	钵
缽	钵
鉢	钵
鈳	钶
鉕	钷
鈽	钸
鈸	钹
鉞	钺
鉆	钻
鑚	钻
鑽	钻
鉬	钼
鉭	钽
鉀	钾
鈿	钿
鈾	铀
鐵	铁
鉑	铂
鈴	铃
鑠	铄
鈆	铅 𫓪
鉛	铅
鉚	铆
鈰	铈
鉉	铉
鉈	铊
鉍	铋
鈮	铌
鈹	铍
鐸	铎
鉶	铏
銬	铐
銠	铑
鉺	铒
鋩	铓
錏	铔
銪	铕
鋮	铖
鋏	铗
鋣	铘
鐃	铙
銍	铚
鐺	铛
銅	铜
鋁	铝
銱	铞
銦	铟
鎧	铠
鍘	铡
銖	铢
銑	铣
鋌	铤
銩	铥
銛	铦
鏵	铧
銓	铨
鎩	铩
鉿	铪
銚	铫
鉻	铬
銘	铭
錚	铮
銫	铯
鉸	铰
銥	铱
剷	铲
鏟	铲
銃	铳
鐋	铴
銨	铵
銀	银
銣	铷
鑄	铸
鐒	铹
舖	铺
鋪	铺
鋙	铻
錸	铼
鋱	铽
鏈	链
鏗	铿
銷	销
鎖	锁
鎻	锁
鋰	锂
鋥	锃
耡	锄
鉏	锄
鋤	锄
鍋	锅
鋯	锆
鋨	锇
銹	锈
鏽	锈
剉	锉
銼	锉
鋝	锊
鋒	锋
鋅	锌
鋶	锍
鐦	锎
鐧	锏
銳	锐
鋭	锐
銻	锑
鋃	锒
鋟	锓
鋦	锔
錒	锕
錆	锖
鍺	锗
鍩	锘
錯	错
錨	锚
錛	锛
錡	锜
鍀	锝
錁	锞
錕	锟
錩	锠
錫	锡
錮	锢
鑼	锣
錘	锤
鎚	锤
錐	锥
錦	锦
鑕	锧
鍁	锨
錈	锩
鍃	锪
鉳	锫
錇	锫
錟	锬
錠	锭
鍵	键
鋸	锯
錳	锰
錙	锱
鍥	锲
鍈	锳
鍇	锴
鏘	锵
鍶	锶
鍔	锷
鍤	锸
鍫	锹
鍬	锹
鍛	锻
鎪	锼
鍠	锽
鍰	锾
鎄	锿
鍍	镀
鎂	镁
鏤	镂
鎡	镃
鐨	镄
鎇	镅
鏌	镆
鎭	镇
鎮	镇
鎛	镈
鎘	镉
鑷	镊
鎲	镋
钂	镋
鎸	镌
鐫	镌
鎳	镍
錼	镎
鎿	镎
鎦	镏
鎬	镐
鎊	镑
鎰	镒
鎵	镓
鑌	镔
鎔	镕
鏢	镖
鏜	镗
鏝	镘
鏍	镙
鏰	镚
鏞	镛
鏡	镜
鏑	镝
鏃	镞
鏐	镠
鐔	镡
鐝	镢
钁	镢 䦆
鐐	镣
鏷	镤
鑥	镥
鐓	镦
鑭	镧
鐠	镨
鑹	镩
鏹	镪
鐙	镫
鑊	镬
鐳	镭
鐶	镮
鐲	镯
䥥	镰
鎌	镰
鐮	镰
鐿	镱
鑔	镲
鑣	镳 镖
鑞	镴
鑱	镵
鑲	镶
長	长
門	门
閂	闩
閃	闪
閆	闫
閈	闬
閉	闭
問	问
闖	闯
閏	闰
闈	闱
閑	闲
閒	闲
閎	闳
間	间
閔	闵
閌	闶
悶	闷
牐	闸
閘	闸
閙	闹
鬧	闹
閨	闺
聞	闻
闥	闼
閩	闽
閭	闾
闓	闿
閥	阀
閣	阁
閡	阂
閫	阃
鬮	阄
閱	阅
閲	阅
閬	阆
闍	阇
閾	阈
閹	阉
閶	阊
鬩	阋
閿	阌
閽	阍
閻	阎
閼	阏
闡	阐
闌	阑
闃	阒
闠	阓
濶	阔
闊	阔
闋	阕
闔	阖
闐	阗
闒	阘
闕	阙
闞	阚
闤	阛
隊	队
阪	阪 坂
穽	阱
陽	阳
陰	阴
隂	阴
陣	阵
堦	阶
階	阶
坿	附
際	际
陸	陆
隴	陇
陳	陈
陘	陉
陝	陕
隯	陦
隉	陧
隕	陨
險	险
隨	随
隱	隐
隷	隶
隸	隶
𨽻	隶
雋	隽
難	难
鴈	雁
僱	雇
雝	雍
雛	雏
彫	雕
琱	雕
鵰	雕
靂	雳
霧	雾
霽	霁
黴	霉
蜺	霓
霢	霡
靄	霭
覇	霸
靚	靓
靝	靔
靜	静
麪	面
麫	面
麵	面
靨	靥
鞾	靴 𫖇
鞵	鞋
鞌	鞍
韃	鞑
鞽	鞒
韉	鞯
韋	韦
靭	韧
靱	韧
韌	韧
韍	韨
韓	韩
韙	韪
韞	韫
韜	韬
韮	韭
韻	韵
頁	页
頂	顶
頃	顷
頇	顸
項	项
順	顺
須	须
鬚	须
頊	顼
頑	顽
顧	顾
頓	顿
頎	颀
頒	颁
頌	颂
頏	颃
預	预
顱	颅
領	领
頗	颇
頸	颈
頡	颉
頰	颊
頲	颋
頜	颌
潁	颍
熲	颎
頦	颏
頤	颐
頻	频
頮	颒
穨	颓
頹	颓
頽	颓
頷	颔
穎	颖
頴	颖 颕
顆	颗
題	题
顒	颙
顎	颚
顓	颛
顏	颜
顔	颜
頟	额
額	额
顳	颞
顢	颟
顛	颠
顙	颡
顥	颢
纇	颣
顫	颤
顬	颥
顰	颦
顴	颧
風	风
颭	飐
颮	飑
䬃	飒
颯	飒
颶	飓
𩗗	飓
颸	飔
颼	飕
颻	飖
飀	飗
飃	飘
飄	飘
飆	飙
飈	飚
飛	飞
飱	飧
饗	飨
饜	餍
飠	饣
飣	饤
飢	饥
饑	饥
飥	饦
餳	饧
飩	饨
餼	饩
飪	饪
餁	饪
飫	饫
飭	饬
飯	饭
㱃	饮
飲	饮
餞	饯
飾	饰
飽	饱
飤	饲
飼	饲
飿	饳
飴	饴
餌	饵
饒	饶
餉	饷
饟	饷 𫗵
餄	饸
餎	饹
餃	饺
餏	饻
餅	饼
餑	饽
餖	饾
餓	饿
餒	馁
餕	馂
餜	馃
餛	馄
餡	馅
舘	馆
館	馆
餷	馇
餽	馈
饋	馈
餶	馉
餿	馊
饞	馋
饁	馌
饃	馍
饝	馍
餺	馎
餾	馏
饈	馐
饉	馑
饅	馒
饊	馓
籑	馔
饌	馔
饢	馕
馬	马
馭	驭
䭾	驮
馱	驮
馴	驯
馳	驰
敺	驱
駈	驱
驅	驱
馹	驲
駁	驳
駮	驳
驢	驴
駔	驵
駛	驶
駟	驷
駙	驸
駒	驹
騶	驺
駐	驻
駝	驼
駞	驼 𫘞
駑	驽
駕	驾
驛	驿
駘	骀
驍	骁
罵	骂
駡	骂
駰	骃
驕	骄
驊	骅
駱	骆
駭	骇
駢	骈
驫	骉
驪	骊
騁	骋
騐	验
驗	验
騂	骍
駸	骎
駿	骏
騏	骐
騎	骑
騍	骒
騅	骓
驌	骕
驂	骖
騙	骗
騭	骘
騤	骙
騷	骚
騖	骛
驁	骜
騮	骝
騫	骞
騸	骟
驃	骠
騾	骡
驘	骡
驄	骢
驏	骣
驟	骤
驥	骥
驦	骦
驤	骧
髏	髅
髖	髋
髕	髌
髥	髯
騌	鬃 骔
騣	鬃
鬉	鬃
鬢	鬓
鬹	鬶
䰟	魂
魘	魇
魎	魉
魚	鱼
魛	鱽
魢	鱾
魷	鱿
魨	鲀
魯	鲁
魴	鲂
䰾	鲃
魺	鲄
鮁	鲅
鮃	鲆
鮎	鲇
鱸	鲈
鮋	鲉
鮓	鲊
鮒	鲋
鮊	鲌
鮑	鲍
鱟	鲎
鮍	鲏
鮐	鲐
鮭	鲑
鮚	鲒
鮳	鲓
鮪	鲔
鮞	鲕
鮦	鲖
鰂	鲗
鮜	鲘
鱠	鲙
鱭	鲚
鮫	鲛
尟	鲜
尠	鲜
鮮	鲜
鱻	鲜
鮺	鲝
鮝	鲞
鯗	鲞
鱘	鲟
骾	鲠
鯁	鲠
鱺	鲡
鰱	鲢
鰹	鲣
鯉	鲤
鰣	鲥
鰷	鲦
鯀	鲧
鯊	鲨
鯇	鲩
鮶	鲪
鯽	鲫
鯒	鲬
鯖	鲭
鯪	鲮
鯕	鲯
鯫	鲰
鯡	鲱
鯤	鲲
鯧	鲳
鯝	鲴
鯢	鲵
鯰	鲶
鯛	鲷
鯨	鲸
鰺	鲹
鯴	鲺
鯔	鲻
鱝	鲼
鰈	鲽
鰏	鲾
鱨	鲿
鯷	鳀
鰛	鳁
鰮	鳁
鰃	鳂
鰓	鳃
鰐	鳄
鱷	鳄
鰍	鳅
鰒	鳆
鰉	鳇
鰁	鳈
鱂	鳉
鯿	鳊
鰠	鳋
鰲	鳌
鼇	鳌
鰭	鳍
鰨	鳎
鰥	鳏
鰩	鳐
鰟	鳑
鰜	鳒
鰳	鳓
鰾	鳔
鱈	鳕
鱉	鳖
鼈	鳖
鰻	鳗
鰵	鳘
鱅	鳙
䲁	鳚
鰼	鳛
鱖	鳜
鱓	鳝
鱔	鳝
鱗	鳞
鱒	鳟
鱯	鳠
鱤	鳡
鱧	鳢
鱣	鳣
䲘	鳤
鳥	鸟
鳩	鸠
雞	鸡
鷄	鸡
鳶	鸢
鳴	鸣
鳲	鸤
鷗	鸥
鴉	鸦
鵶	鸦
鶬	鸧
鴇	鸨
酖	鸩
鴆	鸩
鴣	鸪
鶇	鸫
鸕	鸬
鴨	鸭
鴞	鸮
鴦	鸯
鴒	鸰
鴟	鸱
鴝	鸲
鴛	鸳
鷽	鸴
鴕	鸵
鷥	鸶
鷙	鸷
鴯	鸸
鴰	鸹
鵂	鸺
鴴	鸻
鵃	鸼
鴿	鸽
鸞	鸾
鴻	鸿
鵐	鹀
鵓	鹁
鸝	鹂
鵑	鹃
鵠	鹄
䳘	鹅
鵝	鹅
鵞	鹅
鵒	鹆
鷳	鹇
鷴	鹇
鵜	鹈
鵡	鹉
鵲	鹊
鶓	鹋
鵪	鹌
鵾	鹍
鵯	鹎
鵬	鹏
鵮	鹐
鶉	鹑
鶊	鹒
鵷	鹓
鷫	鹔
鶘	鹕
鶡	鹖
鶚	鹗
鶻	鹘
鶖	鹙
鶿	鹚
鷀	鹚
鶥	鹛
鶩	鹜
鷊	鹝
鷂	鹞
鶲	鹟
鶹	鹠
鶺	鹡
鷁	鹢
鶼	鹣
鶴	鹤
鷖	鹥
鸚	鹦
鷓	鹧
鷚	鹨
鷯	鹩
鷦	鹪
鷲	鹫
鷸	鹬
鷺	鹭
䴉	鹮
鸇	鹯
鷹	鹰
鸌	鹱
鸏	鹲
鸛	鹳
鸘	鹴
鹺	鹾
麐	麟
麥	麦
䴸	麸
粰	麸
麩	麸
痲	麻 痳
蔴	麻
黃	黄
黌	黉
黶	黡
黷	黩
黲	黪
黽	黾
黿	鼋
鼂	鼌
鼉	鼍
皷	鼓
鼴	鼹
齊	齐
齏	齑
齒	齿
齔	龀
齕	龁
齗	龂
齟	龃
齡	龄
齙	龅
齠	龆
齜	龇
齦	龈
齬	龉
齪	龊
齲	龋
齷	龌
龍	龙
龔	龚
龕	龛
龜	龟
䃮	鿎
䥑	鿏
鿓	鿒
鎶	鿔
𠁞	𠀾
儣	𠆲
𠌥	𠆿
俓	𠇹
㒓	𠉂
𠏢	𠉗
儭	𠋆
𠠎	𠚳
剾	𠛅
𠞆	𠛆
𪟖	𠛾
嗰	𠮶
哯	𠯟
噅	𠯠
㘉	𠰱
嚧	𠰷
囃	𠱞
𡅏	𠲥
𡃕	𠴛
𡄔	𠴢
𡄣	𠵸
㗲	𠵾
𡓾	𡋀
𡑭	𡋗
壗	𡋤
𡔖	𡍣
壈	𡒄
㜷	𡝠
㜗	𡞋
㜢	𡞱
孎	𡠟
孻	𡥧
𡮉	𡭜
𡮣	𡭬
𡳳	𡳃
𦘧	𡳒
嵼	𡶴
𡽗	𡸃
嶈	𡺃
嶘	𡺄
㢝	𢋈
㦛	𢗓
𢤱	𢘙
𢣚	𢘝
𢣭	𢘞
愻	𢙏
憹	𢙐
𢠼	𢙑
憢	𢙒
懀	𢙓
㦎	𢛯
懎	𢠁
𤢻	𢢐
𢷮	𢫊
𢶫	𢫞
摋	𢫬
擫	𢬍
𢹿	𢬦
斅	𢽾
斸	𣃁
曥	𣆐
𣋋	𣈣
𦢈	𣍨
腪	𣍯
脥	𣍰
臗	𣎑
槫	𣏢
桱	𣐕
欍	𣐤
𣠲	𣑶
楇	𣒌
橯	𣓿
樤	𣔌
樠	𣗊
欓	𣗋
㰙	𣗙
㯤	𣘐
𣞻	𣘓
檭	𣘴
𣝕	𣘷
欘	𣚚
𣠩	𣞎
殢	𣨼
𣯴	𣭤
𣯩	𣯣
氭	𣱝
湋	𣲗
潕	𣲘
㵗	𣳆
澅	𣶩
𣿉	𣶫
𪷓	𣶭
𤅶	𣷷
濆	𣸣
灙	𣺼
𤁣	𣺽
瀃	𣽷
熓	𤆡
㷍	𤆢
爄	𤇃
熌	𤇄
爖	𤇭
熚	𤇹
熉	𤈶
㷿	𤈷
𤒎	𤊀
𤓩	𤊰
熡	𤋏
㸇	𤎺
𤓎	𤎺
𤑳	𤎻
𤛮	𤙯
𤢟	𤝢
獩	𤞃
玁	𤞤
㺏	𤠋
瓕	𤦀
瓛	𤩽
𤳸	𤳄
癐	𤶊
𤸫	𤶧
㿗	𤻊
㿧	𤽯
皟	𤾀
麬	𤿲
䀉	𥁢
𥌃	𥅘
䀹	𥅴
𥊝	𥅿
瞤	𥆧
䁪	𥇢
䂎	𥎝
礒	𥐟
𥖅	𥐯
𥕥	𥐰
碙	𥐻
𥞵	𥞦
𥨐	𥧂
𥪂	𥩺
籅	𥫣
䉙	𥬀
籋	𥬞
篘	𥬠
𥵊	𥭉
𥸠	𥮋
䉲	𥮜
篸	𥮾
𥵃	𥱔
𥼽	𥹥
䊭	𥺅
𥽖	𥺇
𥿊	𦈈
緷	𦈉
綇	𦈋
綀	𦈌
繟	𦈎
緍	𦈏
縺	𦈐
緸	𦈑
𦂅	𦈒
䋿	𦈓
縎	𦈔
緰	𦈕
䌈	𦈖
𦃄	𦈗
䌋	𦈘
䌰	𦈙
縬	𦈚
繓	𦈛
䌖	𦈜
繏	𦈝
䌟	𦈞
䌝	𦈟
䌥	𦈠
繻	𦈡
䍽	𦍠
朥	𦛨
膢	𦝼
𦣎	𦟗
𦪽	𦨩
蓧	𦰏
䕳	𦰴
爇	𦶟
𦾟	𦶻
蘟	𦻕
𧕟	𧉐
䗿	𧉞
𧎈	𧌥
蠙	𧏖
蠀	𧏗
蠾	𧑏
𧔥	𧒭
䙱	𧜭
襰	𧝝
𧟀	𧝧
詀	𧮪
𧳟	𧳕
䞈	𧹑
𧶔	𧹓
䝻	𧹕
賟	𧹖
贃	𧹗
𨇁	𧿈
躘	𨀁
𨄣	𨀱
𨅍	𨁴
𨈊	𨂺
𨈌	𨄄
䠱	𨅛
𨇞	𨅫
躝	𨅬
軉	𨉗
軗	𨐅
𨊻	𨐆
𨏠	𨐇
輄	𨐈
𨎮	𨐉
𨏥	𨐊
䢨	𨑹
𨣞	𨟳
𨣧	𨠨
𨢿	𨡙
𨣈	𨡺
𨤻	𨤰
鎷	𨰾
釳	𨰿
𨥛	𨱀
鈠	𨱁
鈋	𨱂
鈲	𨱃
鈯	𨱄
鉁	𨱅
龯	𨱆
銶	𨱇
鋉	𨱈
鍄	𨱉
𨧱	𨱊
錂	𨱋
鏆	𨱌
鎯	𨱍
鍮	𨱎
鎝	𨱏
𨫒	𨱐
鐄	𨱑
鏉	𨱒
鐎	𨱓
鐏	𨱔
𨮂	𨱕
䥩	𨱖
䦳	𨷿
𨳕	𨸀
𨳑	𨸁
閍	𨸂
閐	𨸃
䦘	𨸄
𨴗	𨸅
𨵩	𨸆
𨵸	𨸇
𨶀	𨸉
𨶏	𨸊
𨶲	𨸋
𨶮	𨸌
𨷲	𨸎
𨽏	𨸘
䧢	𨸟
䪏	𩏼
𩏪	𩏽
𩎢	𩏾
䪘	𩏿
䪗	𩐀
顂	𩓋
𩓣	𩖕
顃	𩖖
䫴	𩖗
颰	𩙥
𩗀	𩙦
䬞	𩙧
𩘹	𩙨
𩘀	𩙩
颷	𩙪
颾	𩙫
𩘺	𩙬
𩘝	𩙭
䬘	𩙮
䬝	𩙯
𩙈	𩙰
𩚛	𩟿
𩚥	𩠀
𩚵	𩠁
𩛆	𩠂
𩛩	𩠃
𩟐	𩠅
𩜦	𩠆
䭀	𩠇
䭃	𩠈
𩜇	𩠉
𩜵	𩠊
𩝔	𩠋
餸	𩠌
𩞄	𩠎
𩞦	𩠏
𩠴	𩠠
𩡣	𩡖
𩡺	𩧦
駎	𩧨
𩤊	𩧩
䮾	𩧪
駚	𩧫
𩢡	𩧬
䭿	𩧭
𩢾	𩧮
驋	𩧯
䮝	𩧰
𩥉	𩧱
駧	𩧲
𩢸	𩧳
駩	𩧴
𩢴	𩧵
𩣏	𩧶
𩣫	𩧸
駶	𩧺
𩣵	𩧻
𩣺	𩧼
䮠	𩧿
騔	𩨀
䮞	𩨁
騝	𩨃
騪	𩨄
𩤸	𩨅
𩤙	𩨆
䮫	𩨇
騟	𩨈
𩤲	𩨉
騚	𩨊
𩥄	𩨋
𩥑	𩨌
𩥇	𩨍
龭	𩨎
䮳	𩨏
𩧆	𩨐
䯤	𩩈
𩭙	𩬣
𩰀	𩬤
鬖	𩭹
𩯳	𩯒
𩰹	𩰰
𩳤	𩲒
𩴵	𩴌
魥	𩽹
𩵩	𩽺
𩵹	𩽻
鯶	𩽼
𩶱	𩽽
鮟	𩽾
𩶰	𩽿
鯄	𩾁
䲖	𩾂
鮸	𩾃
𩷰	𩾄
𩸃	𩾅
𩸦	𩾆
鯱	𩾇
䱙	𩾈
䱬	𩾊
䱰	𩾋
鱇	𩾌
𩽇	𩾎
䲰	𪉂
鳼	𪉃
𩿪	𪉄
𪀦	𪉅
鴲	𪉆
鴜	𪉈
𪁈	𪉉
鷨	𪉊
𪀾	𪉋
𪁖	𪉌
鵚	𪉍
𪂆	𪉎
𪃏	𪉏
𪃍	𪉐
鷔	𪉑
𪄕	𪉒
𪄆	𪉔
𪇳	𪉕
䴬	𪎈
麲	𪎉
麨	𪎊
䴴	𪎋
麳	𪎌
䵳	𪑅
𪔵	𪔭
𪘀	𪚏
𪘯	𪚐
𠿕	𪜎
凙	𪞝
㔋	𪟎
𧷎	𪠀
㓄	𪠟
𠬙	𪠡
唓	𪠳
㖮	𪠵
嚛	𪠸
𠽃	𪠺
嘺	𪡀
嘪	𪡃
噞	𪡋
嗹	𪡏
㗿	𪡛
嘳	𪡞
𡃄	𪡺
㘓	𪢌
𡃤	𪢐
𡂡	𪢒
嚽	𪢕
𡅯	𪢖
囒	𪢠
圞	𪢮
墲	𪢸
埬	𪣆
堚	𪣒
塿	𪣻
𡓁	𪤄
壣	𪤚
𧹈	𪥠
孇	𪥫
嬣	𪥰
嬻	𪥿
孾	𪧀
寠	𪧘
㞞	𪨊
屩	𪨗
𡸗	𪨩
輋	𪨶
𡹬	𪨹
㟺	𪩇
巊	𪩎
巘	𪩘
𡿖	𪩛
幝	𪩷
幩	𪩸
㢗	𪪑
廧	𪪞
𢍰	𪪴
彃	𪪼
徿	𪫌
𢤩	𪫡
㦞	𪫷
憸	𪫺
𢣐	𪬚
𢤿	𪬯
𢯷	𪭝
摐	𪭢
擟	𪭧
𢶒	𪭯
掚	𪭵
撊	𪭾
㨻	𪮃
㩋	𪮋
撧	𪮖
𢺳	𪮳
攋	𪮶
㪎	𪯋
曊	𪰶
膹	𪱥
梖	𪱷
櫅	𪲎
欐	𪲔
檵	𪲛
櫠	𪲮
欇	𪳍
𣜬	𪳗
欑	𪴙
毊	𪵑
霼	𪵣
濿	𪵱
溡	𪶄
𤄷	𪶒
𣽏	𪶮
㵾	𪷍
灒	𪷽
熂	𪸕
𤑹	𪹀
𤓌	𪹠
爥	𪹳
𤒻	𪹹
𤘀	𪺣
𤜆	𪺪
犞	𪺭
獊	𪺷
𤠮	𪺸
㺜	𪺻
猌	𪺽
瑽	𪻐
瓄	𪻨
瑻	𪻲
璝	𪻺
㻶	𪼋
𤬅	𪼴
畼	𪽈
𤳷	𪽝
痮	𪽪
𤷃	𪽭
㿖	𪽮
𤺔	𪽴
瘱	𪽷
盨	𪾔
睍	𪾢
眝	𪾣
矑	𪾦
矉	𪾸
𥏝	𪿊
𥖲	𪿞
𥗇	𪿵
𥜰	𫀌
𥜐	𫀓
䅐	𫀨
䅳	𫀬
𥢷	𫀮
䆉	𫁂
竱	𫁟
鴗	𫁡
𥶽	𫁱
䉑	𫁲
𥯤	𫁳
䉶	𫁷
𥴼	𫁺
簢	𫂃
簂	𫂆
䉬	𫂈
𥴨	𫂖
𥻦	𫂿
𩏷	𫃗
䊺	𫄚
紟	𫄛
䋃	𫄜
𥾯	𫄝
䋔	𫄞
絁	𫄟
絙	𫄠
絧	𫄡
絥	𫄢
繷	𫄣
繨	𫄤
纚	𫄥
𦀖	𫄦
綖	𫄧
絺	𫄨
䋦	𫄩
𦅇	𫄪
綟	𫄫
緤	𫄬
緮	𫄭
䋼	𫄮
𦃩	𫄯
縍	𫄰
繬	𫄱
縸	𫄲
縰	𫄳
繂	𫄴
𦅈	𫄵
繈	𫄶
繶	𫄷
纁	𫄸
纗	𫄹
䍤	𫅅
羵	𫅗
𦒀	𫅥
䎙	𫅭
𦔖	𫅼
聻	𫆏
𦟼	𫆝
𦡝	𫆫
𦧺	𫇘
𦱌	𫇪
蒍	𫇭
蔿	𫇭
蒭	𫇴
蕽	𫇽
蕳	𫈉
葝	𫈎
蔯	𫈟
蕝	𫈵
薆	𫉁
䗅	𫊪
蠦	𫊮
蟜	𫊸
𧒯	𫊹
蟳	𫊻
蟂	𫋇
蟘	𫋌
䙔	𫋲
襗	𫋷
襓	𫋹
襘	𫋻
襀	𫌀
襵	𫌇
𧞫	𫌋
覼	𫌨
覛	𫌪
𧡴	𫌫
𧢄	𫌬
覹	𫌭
䚩	𫌯
𧭹	𫍐
訑	𫍙
訞	𫍚
訜	𫍛
詓	𫍜
𧦝	𫍞
𧦧	𫍟
䛄	𫍠
詑	𫍡
譊	𫍢
詷	𫍣
譑	𫍤
誂	𫍥
譨	𫍦
誺	𫍧
誫	𫍨
諣	𫍩
誋	𫍪
䛳	𫍫
誷	𫍬
𧩕	𫍭
誳	𫍮
諴	𫍯
諰	𫍰
諯	𫍱
謏	𫍲
諥	𫍳
謱	𫍴
謸	𫍵
𧩼	𫍶
謉	𫍷
謆	𫍸
謯	𫍹
𧫝	𫍺
𧬤	𫍼
譞	𫍽
𧭈	𫍾
譾	𫍿
豵	𫎆
貗	𫎌
贚	𫎦
䝭	𫎧
𧸘	𫎨
賝	𫎩
䞋	𫎪
贉	𫎫
䞓	𫎭
䟐	𫎱
䟆	𫎳
𧽯	𫎸
䟃	𫎺
䠆	𫏃
蹳	𫏆
𨂐	𫏌
𨇽	𫏑
𨆪	𫏕
𨇰	𫏞
𨇤	𫏨
軏	𫐄
軕	𫐅
轣	𫐆
軜	𫐇
軷	𫐈
軨	𫐉
軬	𫐊
𨎌	𫐋
軿	𫐌
𨌈	𫐍
輢	𫐎
輖	𫐏
輗	𫐐
輨	𫐑
輷	𫐒
輮	𫐓
𨍰	𫐔
轊	𫐕
轇	𫐖
轐	𫐗
轗	𫐘
轠	𫐙
遱	𫐷
鄟	𫑘
鄳	𫑡
醶	𫑷
釟	𫓥
釨	𫓦
鈇	𫓧
鈛	𫓨
鏦	𫓩
𨥟	𫓫
鉔	𫓬
鉠	𫓭
𨪕	𫓮
銈	𫓯
銊	𫓰
鐈	𫓱
銁	𫓲
𨰋	𫓳
鉾	𫓴
鋠	𫓵
鋗	𫓶
𫒡	𫓷
錽	𫓸
錤	𫓹
鐪	𫓺
錜	𫓻
𨨛	𫓼
錝	𫓽
錥	𫓾
𨨢	𫓿
鐼	𫔁
鍉	𫔂
𨰲	𫔃
鍒	𫔄
鎍	𫔅
䥯	𫔆
鎞	𫔇
鎙	𫔈
𨰃	𫔉
鏥	𫔊
䥗	𫔋
鏾	𫔌
鐇	𫔍
鐍	𫔎
𨬖	𫔏
𨭸	𫔐
𨭖	𫔑
𨮳	𫔒
𨯟	𫔓
鑴	𫔔
𨰥	𫔕
𨲳	𫔖
閗	𫔯
閞	𫔰
𨴹	𫔲
閵	𫔴
䦯	𫔵
闑	𫔶
𨼳	𫔽
𩀨	𫕚
霣	𫕥
𩅙	𫕨
靧	𫖃
䪊	𫖅
𩎖	𫖑
韠	𫖒
𩏂	𫖓
韛	𫖔
韝	𫖕
𩏠	𫖖
𩑔	𫖪
䪴	𫖫
䪾	𫖬
𩒎	𫖭
顗	𫖮
䫂	𫖰
䫀	𫖱
䫟	𫖲
頵	𫖳
𩔳	𫖴
𩓥	𫖵
顅	𫖶
𩔑	𫖷
顣	𫖹
䫶	𫖺
䫻	𫗇
𩗓	𫗈
𩗴	𫗉
䬓	𫗊
飋	𫗋
𩟗	𫗚
飦	𫗞
䬧	𫗟
餦	𫗠
𩚩	𫗡
飵	𫗢
飶	𫗣
𩛌	𫗤
餫	𫗥
餔	𫗦
餗	𫗧
𩛡	𫗨
饠	𫗩
餪	𫗬
餭	𫗮
䭔	𫗰
䭑	𫗱
𩝽	𫗳
饘	𫗴
馯	𫘛
馼	𫘜
駃	𫘝
駊	𫘟
駤	𫘠
駫	𫘡
駻	𫘣
騃	𫘤
騉	𫘥
騊	𫘦
騄	𫘧
騠	𫘨
騜	𫘩
騵	𫘪
騴	𫘫
騱	𫘬
騻	𫘭
䮰	𫘮
驓	𫘯
驙	𫘰
驨	𫘱
鬠	𫘽
𩯁	𫙂
鱮	𫚈
魟	𫚉
鰑	𫚊
鱄	𫚋
魦	𫚌
魵	𫚍
𩶁	𫚎
䱁	𫚏
䱀	𫚐
鮅	𫚑
鮄	𫚒
鮤	𫚓
鮰	𫚔
鰤	𫚕
鮆	𫚖
鮯	𫚗
𩻮	𫚘
鯆	𫚙
鮿	𫚚
鮵	𫚛
䲅	𫚜
𩸄	𫚝
鯬	𫚞
𩸡	𫚟
䱧	𫚠
鯞	𫚡
鰋	𫚢
鯾	𫚣
鰦	𫚤
鰕	𫚥
鰫	𫚦
鰽	𫚧
𩻗	𫚨
𩻬	𫚩
鱊	𫚪
鱢	𫚫
𩼶	𫚬
鱲	𫚭
鳽	𫛚
鳷	𫛛
鴀	𫛜
鴅	𫛝
鴃	𫛞
鸗	𫛟
𩿤	𫛠
鴔	𫛡
鸋	𫛢
鴥	𫛣
鴐	𫛤
鵊	𫛥
鴮	𫛦
𪀖	𫛧
鵧	𫛨
鴳	𫛩
鴽	𫛪
鶰	𫛫
䳜	𫛬
鵟	𫛭
䳤	𫛮
鶭	𫛯
䳢	𫛰
鵫	𫛱
鵩	𫛳
鷤	𫛴
鶌	𫛵
鶒	𫛶
鶦	𫛷
鶗	𫛸
𪃧	𫛹
䳧	𫛺
𪃒	𫛻
䳫	𫛼
鷅	𫛽
𪆷	𫛾
鷐	𫜀
鷩	𫜁
𪅂	𫜂
鷣	𫜃
鷷	𫜄
䴋	𫜅
𪉸	𫜊
麷	𫜑
䴱	𫜒
𪌭	𫜓
䴽	𫜔
𪍠	𫜕
䵴	𫜙
𪓰	𫜟
䶕	𫜨
𫜦	𫜫
齰	𫜬
齭	𫜭
齴	𫜮
𪙏	𫜯
齾	𫜰
龓	𫜲
䶲	𫜳
㑮	𫝈
𠐊	𫝋
㛝	𫝦
㜐	𫝧
媈	𫝨
嬦	𫝩
𡟫	𫝪
婡	𫝫
嬇	𫝬
孆	𫝭
孄	𫝮
嶹	𫝵
𦠅	𫞅
潣	𫞗
澬	𫞚
㶆	𫞛
灍	𫞝
爧	𫞠
爃	𫞡
𤛱	𫞢
㹽	𫞣
珼	𫞥
璾	𫞦
𤩂	𫞧
璼	𫞨
璊	𫞩
𥢶	𫞷
絍	𫟃
綋	𫟄
綡	𫟅
緟	𫟆
𦆲	𫟇
䖅	𫟑
䕤	𫟕
訨	𫟞
詊	𫟟
譂	𫟠
誴	𫟡
䜖	𫟢
䡐	𫟤
䡩	𫟥
䡵	𫟦
𨞺	𫟫
𨟊	𫟬
釚	𫟲
釲	𫟳
鈖	𫟴
鈗	𫟵
銏	𫟶
鉝	𫟷
鉽	𫟸
鉷	𫟹
䤤	𫟺
銂	𫟻
鐽	𫟼
𨧰	𫟽
𨩰	𫟾
鎈	𫟿
䥄	𫠀
鑉	𫠁
閝	𫠂
韚	𫠅
頍	𫠆
𩖰	𫠇
䫾	𫠈
䮄	𫠊
騼	𫠋
𩦠	𫠌
𩵦	𫠏
魽	𫠐
䱸	𫠑
鱆	𫠒
𩿅	𫠖
齯	𫠜
僤	𫢸
𣍐	𫧃
𪋿	𫧮
㘔	𫬐
塸	𫭟
埨	𫭢
𡑍	𫭼
墠	𫮃
娙	𫰛
㠣	𫵷
嵽	𫶇
廞	𫷷
彄	𫸩
暐	𬀩
晛	𬀪
梜	𬂩
櫍	𬃊
澫	𬇕
浿	𬇙
漍	𬇹
熰	𬉼
燖	𬊈
燀	𬊤
瓅	𬍛
璗	𬍡
璕	𬍤
礐	𬒈
𥗽	𬒗
篢	𬕂
紃	𬘓
紞	𬘘
絪	𬘡
綎	𬘩
綄	𬘫
綪	𬘬
綝	𬘭
綧	𬘯
縯	𬙂
纆	𬙊
纕	𬙋
蔄	𬜬
䓣	𬜯
蘋	𬞟 苹
虉	𬟁
蝀	𬟽
訏	𬣙
詝	𬣞
諓	𬣡
詪	𬣳
諲	𬤇
諟	𬤊
譓	𬤝
軝	𬨂
輶	𬨎
鄩	𬩽
醲	𬪩
釴	𬬩
錀	𬬭
鋹	𬬮
釿	𬬱
鉥	𬬸
鉮	𬬹
鉊	𬬿
鉧	𬭁
𨧀	𬭊
鋐	𬭎
錞	𬭚
𨨏	𬭛
鍭	𬭤
鎓	𬭩
鏏	𬭬
鏚	𬭭
䥕	𬭯
𨭎	𬭳
𨭆	𬭶
鏻	𬭸
鐩	𬭼
闉	𬮱
隑	𬮿
隮	𬯀
隤	𬯎
頔	𬱖
頠	𬱟
駓	𬳵
駉	𬳶
駪	𬳽
駼	𬳿
騑	𬴂
騞	𬴃
驎	𬴊
鮈	𬶋
鮀	𬶍
鮠	𬶏
鮡	𬶐
鯻	𬶟
鰊	𬶠
鱀	𬶨
鰶	𬶭
鱚	𬶮
鵏	𬷕
鶠	𬸘
鸑	𬸚
鶱	𬸣
鷟	𬸦
鷭	𬸪
鷿	𬸯
齘	𬹼
齮	𬺈
齼	𬺓
繐	𰬸
菕	𰰨
譅	𰶎
鋂	𰾄
鑀	𰾭
𪈼	𱊜
一沈	一沉
下沈	下沉
会沈	会沉
會沈	会沉
低沈	低沉
击沈	击沉
擊沈	击沉
半沈	半沉
墨沈	墨沉
弄沈	弄沉
打沈	打沉
昏沈	昏沉
沈下	沉下
沈不	沉不
沈了	沉了
沈于	沉于
沈於	沉于
沈住	沉住
沈入	沉入
沈冤	沉冤
沈到	沉到
沈勇	沉勇
沈厚	沉厚
沈向	沉向
沈吟	沉吟
沈在	沉在
沈寂	沉寂
沈思	沉思
沈沈	沉沉
沈沒	沉没
沈没	沉没
沈沦	沉沦
沈淪	沉沦
沈浊	沉浊
沈濁	沉浊
沈浮	沉浮
沈浸	沉浸
沈淀	沉淀
沈澱	沉淀
沈湎	沉湎
沈溺	沉溺
沈滞	沉滞
沈滯	沉滞
沈潛	沉潜
沈潜	沉潜
沈瓮	沉瓮
沈甕	沉瓮
沈疴	沉疴
沈痾	沉疴
沈痛	沉痛
沈痼	沉痼
沈的	沉的
沈眠	沉眠
沈着	沉着
沈著	沉着
沈睡	沉睡
沈积	沉积
沈積	沉积
沈稳	沉稳
沈穩	沉稳
沈筒	沉筒
沈船	沉船
沈落	沉落
沈进	沉进
沈進	沉进
沈迷	沉迷
沈郁	沉郁
沈鬱	沉郁
沈醉	沉醉
沈重	沉重
沈鈍	沉钝
沈钝	沉钝
沈悶	沉闷
沈闷	沉闷
沈降	沉降
沈陷	沉陷
沈静	沉静
沈靜	沉静
沈香	沉香
沈默	沉默
浮沈	浮沉
消沈	消沉
深沈	深沉
石沈	石沉
耳沈	耳沉
船沈	船沉
西沈	西沉
阴沈	阴沉
陰沈	阴沉
烏沈沈	乌沉沉
墨沈沈	墨沉沉
沈住氣	沉住气
沈澱法	沉淀法
沈澱物	沉淀物
沈甸甸	沉甸甸
沈砂池	沉砂池
沈積石	沉积石
陰沈沈	阴沉沉
黑沈沈	黑沉沉
任筆沈詩	任笔沉诗
死氣沈沈	死气沉沉
沈得住氣	沉得住气
沈思往事	沉思往事
沈湎酒色	沉湎酒色
沈靜下來	沉静下来
沈魚落雁	沉鱼落雁
沈默寡言	沉默寡言
破釜沈舟	破釜沉舟
載浮載沈	载浮载沉
陰陰沈沈	阴阴沉沉
雁杳魚沈	雁杳鱼沉
魚沈雁杳	鱼沉雁杳
乾东	乾东
乾東	乾东
乾仪	乾仪
乾儀	乾仪
乾元	乾元
乾兴	乾兴
乾興	乾兴
乾冈	乾冈
乾岡	乾冈
乾刘	乾刘
乾劉	乾刘
乾刚	乾刚
乾剛	乾刚
乾务	乾务
乾務	乾务
乾卦	乾卦
乾縣	乾县
乾启	乾启
乾啟	乾启
乾嘉	乾嘉
乾圖	乾图
乾坤	乾坤
乾宁	乾宁
乾寧	乾宁
乾宅	乾宅
乾岗	乾岗
乾崗	乾岗
乾录	乾录
乾錄	乾录
乾斷	乾断
乾旦	乾旦
乾晖	乾晖
乾暉	乾晖
乾曜	乾曜
乾构	乾构
乾構	乾构
乾栋	乾栋
乾棟	乾栋
乾灵	乾灵
乾靈	乾灵
乾窦	乾窦
乾竇	乾窦
乾笃	乾笃
乾篤	乾笃
乾紅	干红 乾红
乾綱	乾纲
乾紐	乾纽
乾纽	乾纽
乾絡	乾络
乾络	乾络
乾統	乾统
乾统	乾统
乾維	乾维
乾维	乾维
乾荫	乾荫
乾蔭	乾荫
乾象	乾象
乾貞	乾贞
乾贞	乾贞
乾貺	乾贶
乾贶	乾贶
乾車	乾车
乾车	乾车
乾軸	乾轴
乾轴	乾轴
乾造	乾造
乾道	乾道
乾鉴	乾鉴
乾鑒	乾鉴
乾鈞	乾钧
乾钧	乾钧
乾闥	乾闼
乾闼	乾闼
乾陵	乾陵
乾隆	乾隆
乾顧	乾顾
乾顾	乾顾
乾風	乾风
乾风	乾风
乾馬	乾马
乾马	乾马
乾鵠	乾鹄
乾鹄	乾鹄
乾鵲	乾鹊
乾鹊	乾鹊
乾龍	乾龙
乾龙	乾龙
康乾	康乾
乾为天	乾为天
乾為天	乾为天
乾为阳	乾为阳
乾為陽	乾为阳
乾清宮	乾清宫
乾盛世	乾盛世
乾象历	乾象历
乾象歷	乾象历
男为乾	男为乾
男為乾	男为乾
阳为乾	阳为乾
陽為乾	阳为乾
乾坤一擲	乾坤一掷
乾坤再造	乾坤再造
乾隆年間	乾隆年间
乾隆皇帝	乾隆皇帝
壺裏乾坤	壶里乾坤
天道为乾	天道为乾
天道為乾	天道为乾
扭轉乾坤	扭转乾坤
旋乾轉坤	旋乾转坤
旋轉乾坤	旋转乾坤
朝乾夕惕	朝乾夕惕
浪蕩乾坤	浪荡乾坤
袖裏乾坤	袖里乾坤
顛乾倒坤	颠乾倒坤
顛倒乾坤	颠倒乾坤
上帳	上账
買帳	买账
了帳	了账
交帳	交账
付帳	付账
會帳	会账
倒帳	倒账
入帳	入账
沖帳	冲账
勾帳	勾账
呆帳	呆账
哈帳	哈账
壞帳	坏账
大帳	大账
夾帳	夹账
宕帳	宕账
對帳	对账
小帳	小账
開帳	开账
總帳	总账
惠帳	惠账
打帳	打账
找帳	找账
折帳	折账
報帳	报账
抵帳	抵账
押帳	押账
拆帳	拆账
收帳	收账
放帳	放账
舊帳	旧账
查帳	查账
沒帳	没账
清帳	清账
漂帳	漂账
爛帳	烂账
盤帳	盘账
瞎帳	瞎账
筆帳	笔账
簽帳	签账
算帳	算账
管帳	管账
籍帳	籍账
經帳	经账
結帳	结账
老帳	老账
花帳	花账
落帳	落账
虛帳	虚账
要帳	要账
計帳	计账
認帳	认账
討帳	讨账
記帳	记账
該帳	该账
帳主	账主
帳冊	账册
帳務	账务
帳單	账单
帳號	账号
帳幕	账幕
帳戶	账户
帳房	账房
帳本	账本
帳款	账款
帳目	账目
帳簿	账簿
帳籍	账籍
帳面	账面
賒帳	赊账
賠帳	赔账
賴帳	赖账
轉帳	转账
過帳	过账
還帳	还账
進帳	进账
銷帳	销账
陳帳	陈账
倒反帳	倒反账
分類帳	分类账
客帳司	客账司
序時帳	序时账
開花帳	开花账
打夾帳	打夹账
打料帳	打料账
打虛帳	打虚账
流年帳	流年账
流水帳	流水账
現金帳	现金账
立帳子	立账子
糊塗帳	胡涂账
資本帳	资本账
閻王帳	阎王账
隔壁帳	隔壁账
寬打料帳	宽打料账
欺瞞夾帳	欺瞒夹账
专著	专著
專著	专著
藉着	借着
藉著	借着
偷著	偷着
卓著	卓著
原著	原著
合著	合着 合著
名著	名著
圍著	围着
土著	土著
巨著	巨著
鉅著	巨著
所著	所着 所著
抱著	抱着
拎著	拎着
拙著	拙著
拿著	拿着
挨著	挨着
接著	接着
撰著	撰著
昭著	昭著
显著	显著
顯著	显著 显着
盯著	盯着
著式	着式 著式
著志	着志 著志
著有	着有 著有
著白	着白 著白
睡著	睡着
穿著	穿着
站著	站着
背著	背着
著书	著书
著書	著书
著于	著于
著於	著于
著作	著作
著名	著名
著录	著录
著錄	著录
著称	著称
著稱	著称
著者	著者
著述	著述
論著	论著
论著	论著
譯著	译著
译著	译著
跟著	跟着
跪著	跪着
遗著	遗著
遺著	遗著
長著	长着 长著
隨著	随着
領著	领着
人合著	人合著
憑藉著	凭借着
發揮著	发挥着
合著人	合著人
合著的	合著的
微知著	微知著
所著的	所著的
指名著	指名著 指名着
放著錄	放着录
比合著	比合著
照著書	照着书
著錄像	着录像
著錄取	着录取
著錄影	着录影
著錄音	着录音
篇長著	篇长著
作者合著	作者合著
合著作者	合著作者
合著关系	合著关系
合著關係	合著关系
合著小說	合著小说
合著小说	合著小说
合著文章	合著文章
合著網絡	合著网络
合著网络	合著网络
合著網路	合著网路
合著网路	合著网路
合著論文	合著论文
合著论文	合著论文
帶著名片	带着名片
拿著作人	拿著作人
拿著作財	拿著作财
文章合著	文章合著
論文合著	论文合著
论文合著	论文合著
上鍊	上链
人鍊	人链
冷鍊	冷链
島鍊	岛链
手鍊	手链
拉鍊	拉链
狗鍊	狗链
珠鍊	珠链
脖鍊	脖链
腳鍊	脚链
表鍊	表链
錶鍊	表链
袖鍊	袖链
褲鍊	裤链
金鍊	金链
鐵鍊	铁链
鉸鍊	铰链
銀鍊	银链
鍊合	链合
鍊咀	链咀
鍊墜	链坠
鍊子	链子
鍊帶	链带
鍊式	链式
鍊形	链形
鍊扣	链扣
鍊條	链条
鍊炮	链炮
鍊牌	链牌
鍊狀	链状
鍊環	链环
鍊球	链球
鍊結	链结
鍊繩	链绳
鍊罩	链罩
鍊表	链表
鍊路	链路
鍊軌	链轨
鍊輪	链轮
鍊轆	链辘
鍊鎖	链锁
鍊錘	链锤
鍊鋸	链锯
鍊餅	链饼
鎖鍊	锁链
錨鍊	锚链
長鍊	长链
項鍊	项链
頸鍊	颈链
產業鍊	产业链
產品鍊	产品链
價值鍊	价值链
傳播鍊	传播链
供應鍊	供应链
利益鍊	利益链
珍珠鍊	珍珠链
生產鍊	生产链
生態鍊	生态链
生物鍊	生物链
資金鍊	资金链
鑰匙鍊	钥匙链
鍊球菌	链球菌
食物鍊	食物链
肘手鍊足	肘手链足
藉代	借代
藉以	借以
藉助	借助
藉勢	借势
藉卉	借卉
藉口	借口
藉喻	借喻
藉手	借手
藉據	借据
藉故	借故
藉方	借方
藉機	借机
藉條	借条
藉此	借此
藉用	借用
藉由	借由
藉端	借端
藉給	借给
藉詞	借词
藉讀	借读
藉資	借资
藉酒	借酒
假藉	假借
凌藉	凌借
憑藉	凭借
滑藉	滑借
藉藉	藉藉
藉助於	借助于
藉寇兵	借寇兵
找藉口	找借口
以免藉口	以免借口
傷亡枕藉	伤亡枕藉
藉故推辭	借故推辞
藉此機會	借此机会
藉箸代籌	借箸代筹
出醜狼藉	出丑狼藉
藉藉无名	藉藉无名
候覆	候复
函覆	函复
反覆	反复
發覆	发复
回覆	回复
覆上	复上
覆信	复信
覆呈	复呈
覆命	复命
覆宗	复宗
覆審	复审
覆幬	复帱
覆文	复文
覆查	复查
覆校	复校
覆核	复核
覆檢	复检
覆電	复电
覆盂	复盂
覆露	复露
待覆	待复
批覆	批复
申覆	申复
電覆	电复
盼覆	盼复
示覆	示复
稟覆	禀复
答覆	答复
見覆	见复
重覆	重复
鈞覆	钧复
買臣覆水	买臣复水
反反覆覆	反反复复
文錦覆阱	文锦复阱
企画	企划
企畫	企划
画分	划分
畫分	划分
画清	划清
畫清	划清
区画	区划
區畫	区划
指畫	指画 指划
比画	比划
比畫	比划
畫一	画一 划一
策画	策划
策畫	策划
筹画	筹划
籌畫	筹划
規畫	规划
规画	规划
計畫	计划
计画	计划
謀畫	谋划
谋画	谋划
重畫	重画 重划
画一化	划一化
畫一化	划一化
画一性	划一性
畫一性	划一性
整齊画一	整齐划一
整齊畫一	整齐划一
伽吒	伽吒
制吒	制吒
史吒	史吒
吒吒	吒吒
吒唎	吒唎
吒枳	吒枳
嗚吒	呜吒
呾吒	呾吒
哪吒	哪吒
囉吒	啰吒
布吒	布吒
木吒	木吒
沙吒	沙吒
波吒	波吒
矩吒	矩吒
羅吒	罗吒
金吒	金吒
闍吒	阇吒
阿吒	阿吒
吒吒吒	吒吒吒
痲子	麻子
痳子	麻子
痲木	麻木
痳木	麻木
痲油	麻油
痳油	麻油
痲疹	麻疹
痳疹	麻疹
痲痹	麻痹
痲痺	麻痹
痳痹	麻痹
痳痺	麻痹
痲疯	麻风
痲瘋	麻风
痲風	麻风
痲风	麻风
痳疯	麻风
痳瘋	麻风
痳風	麻风
痳风	麻风
瞭如	了如
瞭然	了然
瞭若	了若
瞭解	了解
明瞭	明了
不瞭解	不了解
瞭解到	了解到
據瞭解	据了解
一目瞭然	一目了然
瞭如指掌	了如指掌
瞭然於心	了然于心
瞭若指掌	了若指掌
簡單明瞭	简单明了
踅門瞭戶	踅门了户
仇讎	仇雠
校讎	校雠
讎仇	雠仇
讎夷	雠夷
讎定	雠定
讎校	雠校
讎正	雠正
讎問	雠问
無言不讎	无言不雠
攙夥	掺伙
攙假	掺假
攙兌	掺兑
攙口	掺口
攙合	掺合
攙和	掺和
攙奪	掺夺
攙放	掺放
攙雜	掺杂
攙言接語	掺言接语
攙話接舌	掺话接舌
變徵	变徵
徵聲	徵声
徵弦	徵弦
徵絃	徵弦
徵調	徵调
徵音	徵音
流徵	流徵
角徵	角徵
含商咀徵	含商咀徵
含宮咀徵	含宫咀徵
争论	争论
爭論	争论
理論	理论
理论	理论
討論	讨论
讨论	讨论
議論	议论
议论	议论
談論	谈论
谈论	谈论
辯論	辩论
辩论	辩论
評論	评论
评论	评论
么麼	幺麽
么麽	幺麽
幺麼	幺麽
篤麼	笃麽
麼些族	麽些族
拚却	拚却
拚卻	拚却
拚弃	拚弃
拚棄	拚弃
拚絕	拚绝
拚绝	拚绝
拚捨	拚舍
拚舍	拚舍
劄动	劄动
劄動	劄动
劄目	劄目
目劄	目劄
眼劄	眼劄
连劄	连劄
連劄	连劄
衹得	只得
祇是	只是
衹是	只是
衹有	只有
衹要	只要
衹見	只见
衹不過	只不过
噁丁	𫫇丁
噁唑	𫫇唑
噁庚	𫫇庚
噁烷	𫫇烷
吩噁嗪	吩𫫇嗪
喹噁啉	喹𫫇啉
噁二唑	𫫇二唑
春蒐	春蒐
蒐獮	蒐狝
蒐狩	蒐狩
蒐獵	蒐猎
蒐田	蒐田
蒐畋	蒐畋
蒐苗	蒐苗
薙髮	剃发
薙頭	剃头
薙工	剃工
薙度	剃度
薙鬚	剃须
披薙	披剃
瀰濛	弥蒙
空濛	空蒙
濛濛	蒙蒙
迷濛	迷蒙
蘋小	苹小
蘋婆	苹婆
蘋方	苹方
蘋果	苹果
蘋毛蟲	苹毛虫
澳洲青蘋	澳洲青苹
夥頤	夥颐
甚夥	甚夥
趁夥打劫	趁夥打劫
束脩	束脩
脯修	脯脩
腶脩	腶脩
紬次	䌷次
紬繹	䌷绎
剋架	剋架
挨剋	挨剋
倒采	倒彩
喝采	喝彩
扞拒	扞拒
扞格	扞格
牴牾	抵牾
牴觸	抵触
挂名	挂名
掛名	挂名
暗闇	暗闇
蕓薹	芸薹
蒜薹	蒜薹
保鑣	保镖
鑣客	镖客
橡椀	橡椀
於乎	於乎
彷彿	仿佛
傢俱	家具
戮力	勠力
畢昇	毕昇
澹臺	澹台
袷袢	袷袢
宏揚	弘扬
慕名	慕名
˙ㄚ	a
ㄚ	ā
ㄚˊ	á
ㄚˇ	ǎ
ㄚˋ	à
˙ㄞ	ai
ㄞ	āi
ㄞˊ	ái
ㄞˇ	ǎi
ㄞˋ	ài
˙ㄢ	an
ㄢ	ān
ㄢˊ	án
ㄢˇ	ǎn
ㄢˋ	àn
˙ㄤ	ang
ㄤ	āng
ㄤˊ	áng
ㄤˇ	ǎng
ㄤˋ	àng
˙ㄠ	ao
ㄠ	āo
ㄠˊ	áo
ㄠˇ	ǎo
ㄠˋ	ào
˙ㄅㄚ	ba
ㄅㄚ	bā
ㄅㄚˊ	bá
ㄅㄚˇ	bǎ
ㄅㄚˋ	bà
˙ㄅㄞ	bai
ㄅㄞ	bāi
ㄅㄞˊ	bái
ㄅㄞˇ	bǎi
ㄅㄞˋ	bài
˙ㄅㄢ	ban
ㄅㄢ	bān
ㄅㄢˊ	bán
ㄅㄢˇ	bǎn
ㄅㄢˋ	bàn
˙ㄅㄤ	bang
ㄅㄤ	bāng
ㄅㄤˊ	báng
ㄅㄤˇ	bǎng
ㄅㄤˋ	bàng
˙ㄅㄠ	bao
ㄅㄠ	bāo
ㄅㄠˊ	báo
ㄅㄠˇ	bǎo
ㄅㄠˋ	bào
˙ㄅㄟ	bei
ㄅㄟ	bēi
ㄅㄟˊ	béi
ㄅㄟˇ	běi
ㄅㄟˋ	bèi
˙ㄅㄣ	ben
ㄅㄣ	bēn
ㄅㄣˊ	bén
ㄅㄣˇ	běn
ㄅㄣˋ	bèn
˙ㄅㄥ	beng
ㄅㄥ	bēng
ㄅㄥˊ	béng
ㄅㄥˇ	běng
ㄅㄥˋ	bèng
˙ㄅㄧ	bi
ㄅㄧ	bī
ㄅㄧˊ	bí
ㄅㄧˇ	bǐ
ㄅㄧˋ	bì
˙ㄅㄧㄢ	bian
ㄅㄧㄢ	biān
ㄅㄧㄢˊ	bián
ㄅㄧㄢˇ	biǎn
ㄅㄧㄢˋ	biàn
˙ㄅㄧㄠ	biao
ㄅㄧㄠ	biāo
ㄅㄧㄠˊ	biáo
ㄅㄧㄠˇ	biǎo
ㄅㄧㄠˋ	biào
˙ㄅㄧㄝ	bie
ㄅㄧㄝ	biē
ㄅㄧㄝˊ	bié
ㄅㄧㄝˇ	biě
ㄅㄧㄝˋ	biè
˙ㄅㄧㄣ	bin
ㄅㄧㄣ	bīn
ㄅㄧㄣˊ	bín
ㄅㄧㄣˇ	bǐn
ㄅㄧㄣˋ	bìn
˙ㄅㄧㄥ	bing
ㄅㄧㄥ	bīng
ㄅㄧㄥˊ	bíng
ㄅㄧㄥˇ	bǐng
ㄅㄧㄥˋ	bìng
˙ㄅㄛ	bo
ㄅㄛ	bō
ㄅㄛˊ	bó
ㄅㄛˇ	bǒ
ㄅㄛˋ	bò
˙ㄅㄨ	bu
ㄅㄨ	bū
ㄅㄨˊ	bú
ㄅㄨˇ	bǔ
ㄅㄨˋ	bù
˙ㄘㄚ	ca
ㄘㄚ	cā
ㄘㄚˊ	cá
ㄘㄚˇ	cǎ
ㄘㄚˋ	cà
˙ㄘㄞ	cai
ㄘㄞ	cāi
ㄘㄞˊ	cái
ㄘㄞˇ	cǎi
ㄘㄞˋ	cài
˙ㄘㄢ	can
ㄘㄢ	cān
ㄘㄢˊ	cán
ㄘㄢˇ	cǎn
ㄘㄢˋ	càn
˙ㄘㄤ	cang
ㄘㄤ	cāng
ㄘㄤˊ	cáng
ㄘㄤˇ	cǎng
ㄘㄤˋ	càng
˙ㄘㄠ	cao
ㄘㄠ	cāo
ㄘㄠˊ	cáo
ㄘㄠˇ	cǎo
ㄘㄠˋ	cào
˙ㄘㄜ	ce
ㄘㄜ	cē
ㄘㄜˊ	cé
ㄘㄜˇ	cě
ㄘㄜˋ	cè
˙ㄘㄣ	cen
ㄘㄣ	cēn
ㄘㄣˊ	cén
ㄘㄣˇ	cěn
ㄘㄣˋ	cèn
˙ㄘㄥ	ceng
ㄘㄥ	cēng
ㄘㄥˊ	céng
ㄘㄥˇ	cěng
ㄘㄥˋ	cèng
˙ㄔㄚ	cha
ㄔㄚ	chā
ㄔㄚˊ	chá
ㄔㄚˇ	chǎ
ㄔㄚˋ	chà
˙ㄔㄞ	chai
ㄔㄞ	chāi
ㄔㄞˊ	chái
ㄔㄞˇ	chǎi
ㄔㄞˋ	chài
˙ㄔㄢ	chan
ㄔㄢ	chān
ㄔㄢˊ	chán
ㄔㄢˇ	chǎn
ㄔㄢˋ	chàn
˙ㄔㄤ	chang
ㄔㄤ	chāng
ㄔㄤˊ	cháng
ㄔㄤˇ	chǎng
ㄔㄤˋ	chàng
˙ㄔㄠ	chao
ㄔㄠ	chāo
ㄔㄠˊ	cháo
ㄔㄠˇ	chǎo
ㄔㄠˋ	chào
˙ㄔㄜ	che
ㄔㄜ	chē
ㄔㄜˊ	ché
ㄔㄜˇ	chě
ㄔㄜˋ	chè
˙ㄔㄣ	chen
ㄔㄣ	chēn
ㄔㄣˊ	chén
ㄔㄣˇ	chěn
ㄔㄣˋ	chèn
˙ㄔㄥ	cheng
ㄔㄥ	chēng
ㄔㄥˊ	chéng
ㄔㄥˇ	chěng
ㄔㄥˋ	chèng
˙ㄔ	chi
ㄔ	chī
ㄔˊ	chí
ㄔˇ	chǐ
ㄔˋ	chì
˙ㄔㄨㄥ	chong
ㄔㄨㄥ	chōng
ㄔㄨㄥˊ	chóng
ㄔㄨㄥˇ	chǒng
ㄔㄨㄥˋ	chòng
˙ㄔㄡ	chou
ㄔㄡ	chōu
ㄔㄡˊ	chóu
ㄔㄡˇ	chǒu
ㄔㄡˋ	chòu
˙ㄔㄨ	chu
ㄔㄨ	chū
ㄔㄨˊ	chú
ㄔㄨˇ	chǔ
ㄔㄨˋ	chù
˙ㄔㄨㄚ	chua
ㄔㄨㄚ	chuā
ㄔㄨㄚˊ	chuá
ㄔㄨㄚˇ	chuǎ
ㄔㄨㄚˋ	chuà
˙ㄔㄨㄞ	chuai
ㄔㄨㄞ	chuāi
ㄔㄨㄞˊ	chuái
ㄔㄨㄞˇ	chuǎi
ㄔㄨㄞˋ	chuài
˙ㄔㄨㄢ	chuan
ㄔㄨㄢ	chuān
ㄔㄨㄢˊ	chuán
ㄔㄨㄢˇ	chuǎn
ㄔㄨㄢˋ	chuàn
˙ㄔㄨㄤ	chuang
ㄔㄨㄤ	chuāng
ㄔㄨㄤˊ	chuáng
ㄔㄨㄤˇ	chuǎng
ㄔㄨㄤˋ	chuàng
˙ㄔㄨㄟ	chui
ㄔㄨㄟ	chuī
ㄔㄨㄟˊ	chuí
ㄔㄨㄟˇ	chuǐ
ㄔㄨㄟˋ	chuì
˙ㄔㄨㄣ	chun
ㄔㄨㄣ	chūn
ㄔㄨㄣˊ	chún
ㄔㄨㄣˇ	chǔn
ㄔㄨㄣˋ	chùn
˙ㄔㄨㄛ	chuo
ㄔㄨㄛ	chuō
ㄔㄨㄛˊ	chuó
ㄔㄨㄛˇ	chuǒ
ㄔㄨㄛˋ	chuò
˙ㄘ	ci
ㄘ	cī
ㄘˊ	cí
ㄘˇ	cǐ
ㄘˋ	cì
˙ㄘㄨㄥ	cong
ㄘㄨㄥ	cōng
ㄘㄨㄥˊ	cóng
ㄘㄨㄥˇ	cǒng
ㄘㄨㄥˋ	còng
˙ㄘㄡ	cou
ㄘㄡ	cōu
ㄘㄡˊ	cóu
ㄘㄡˇ	cǒu
ㄘㄡˋ	còu
˙ㄘㄨ	cu
ㄘㄨ	cū
ㄘㄨˊ	cú
ㄘㄨˇ	cǔ
ㄘㄨˋ	cù
˙ㄘㄨㄢ	cuan
ㄘㄨㄢ	cuān
ㄘㄨㄢˊ	cuán
ㄘㄨㄢˇ	cuǎn
ㄘㄨㄢˋ	cuàn
˙ㄘㄨㄟ	cui
ㄘㄨㄟ	cuī
ㄘㄨㄟˊ	cuí
ㄘㄨㄟˇ	cuǐ
ㄘㄨㄟˋ	cuì
˙ㄘㄨㄣ	cun
ㄘㄨㄣ	cūn
ㄘㄨㄣˊ	cún
ㄘㄨㄣˇ	cǔn
ㄘㄨㄣˋ	cùn
˙ㄘㄨㄛ	cuo
ㄘㄨㄛ	cuō
ㄘㄨㄛˊ	cuó
ㄘㄨㄛˇ	cuǒ
ㄘㄨㄛˋ	cuò
˙ㄉㄚ	da
ㄉㄚ	dā
ㄉㄚˊ	dá
ㄉㄚˇ	dǎ
ㄉㄚˋ	dà
˙ㄉㄞ	dai
ㄉㄞ	dāi
ㄉㄞˊ	dái
ㄉㄞˇ	dǎi
ㄉㄞˋ	dài
˙ㄉㄢ	dan
ㄉㄢ	dān
ㄉㄢˊ	dán
ㄉㄢˇ	dǎn
ㄉㄢˋ	dàn
˙ㄉㄤ	dang
ㄉㄤ	dāng
ㄉㄤˊ	dáng
ㄉㄤˇ	dǎng
ㄉㄤˋ	dàng
˙ㄉㄠ	dao
ㄉㄠ	dāo
ㄉㄠˊ	dáo
ㄉㄠˇ	dǎo
ㄉㄠˋ	dào
˙ㄉㄜ	de
ㄉㄜ	dē
ㄉㄜˊ	dé
ㄉㄜˇ	dě
ㄉㄜˋ	dè
˙ㄉㄟ	dei
ㄉㄟ	dēi
ㄉㄟˊ	déi
ㄉㄟˇ	děi
ㄉㄟˋ	dèi
˙ㄉㄣ	den
ㄉㄣ	dēn
ㄉㄣˊ	dén
ㄉㄣˇ	děn
ㄉㄣˋ	dèn
˙ㄉㄥ	deng
ㄉㄥ	dēng
ㄉㄥˊ	déng
ㄉㄥˇ	děng
ㄉㄥˋ	dèng
˙ㄉㄧ	di
ㄉㄧ	dī
ㄉㄧˊ	dí
ㄉㄧˇ	dǐ
ㄉㄧˋ	dì
˙ㄉㄧㄚ	dia
ㄉㄧㄚ	diā
ㄉㄧㄚˊ	diá
ㄉㄧㄚˇ	diǎ
ㄉㄧㄚˋ	dià
˙ㄉㄧㄢ	dian
ㄉㄧㄢ	diān
ㄉㄧㄢˊ	dián
ㄉㄧㄢˇ	diǎn
ㄉㄧㄢˋ	diàn
˙ㄉㄧㄠ	diao
ㄉㄧㄠ	diāo
ㄉㄧㄠˊ	diáo
ㄉㄧㄠˇ	diǎo
ㄉㄧㄠˋ	diào
˙ㄉㄧㄝ	die
ㄉㄧㄝ	diē
ㄉㄧㄝˊ	dié
ㄉㄧㄝˇ	diě
ㄉㄧㄝˋ	diè
˙ㄉㄧㄥ	ding
ㄉㄧㄥ	dīng
ㄉㄧㄥˊ	díng
ㄉㄧㄥˇ	dǐng
ㄉㄧㄥˋ	dìng
˙ㄉㄧㄡ	diu
ㄉㄧㄡ	diū
ㄉㄧㄡˊ	diú
ㄉㄧㄡˇ	diǔ
ㄉㄧㄡˋ	diù
˙ㄉㄨㄥ	dong
ㄉㄨㄥ	dōng
ㄉㄨㄥˊ	dóng
ㄉㄨㄥˇ	dǒng
ㄉㄨㄥˋ	dòng
˙ㄉㄡ	dou
ㄉㄡ	dōu
ㄉㄡˊ	dóu
ㄉㄡˇ	dǒu
ㄉㄡˋ	dòu
˙ㄉㄨ	du
ㄉㄨ	dū
ㄉㄨˊ	dú
ㄉㄨˇ	dǔ
ㄉㄨˋ	dù
˙ㄉㄨㄢ	duan
ㄉㄨㄢ	duān
ㄉㄨㄢˊ	duán
ㄉㄨㄢˇ	duǎn
ㄉㄨㄢˋ	duàn
˙ㄉㄨㄟ	dui
ㄉㄨㄟ	duī
ㄉㄨㄟˊ	duí
ㄉㄨㄟˇ	duǐ
ㄉㄨㄟˋ	duì
˙ㄉㄨㄣ	dun
ㄉㄨㄣ	dūn
ㄉㄨㄣˊ	dún
ㄉㄨㄣˇ	dǔn
ㄉㄨㄣˋ	dùn
˙ㄉㄨㄛ	duo
ㄉㄨㄛ	duō
ㄉㄨㄛˊ	duó
ㄉㄨㄛˇ	duǒ
ㄉㄨㄛˋ	duò
˙ㄜ	e
˙ㄝ	ê
ㄜ	ē
ㄝ	ē̂
ㄜˊ	é
ㄝˊ	é̂
ㄜˇ	ě
ㄝˇ	ě̂
ㄜˋ	è
ㄝˋ	è̂
˙ㄣ	en n
ㄣ	ēn n̄
ㄣˊ	én ń
ㄣˇ	ěn ň
ㄣˋ	èn ǹ
˙ㄥ	eng
ㄥ	ēng
ㄥˊ	éng
ㄥˇ	ěng
ㄥˋ	èng
˙ㄦ	er
ㄦˊ	ér
ㄦˇ	ěr
ㄦˋ	èr
˙ㄈㄚ	fa
ㄈㄚ	fā
ㄈㄚˊ	fá
ㄈㄚˇ	fǎ
ㄈㄚˋ	fà
˙ㄈㄢ	fan
ㄈㄢ	fān
ㄈㄢˊ	fán
ㄈㄢˇ	fǎn
ㄈㄢˋ	fàn
˙ㄈㄤ	fang
ㄈㄤ	fāng
ㄈㄤˊ	fáng
ㄈㄤˇ	fǎng
ㄈㄤˋ	fàng
˙ㄈㄟ	fei
ㄈㄟ	fēi
ㄈㄟˊ	féi
ㄈㄟˇ	fěi
ㄈㄟˋ	fèi
˙ㄈㄣ	fen
ㄈㄣ	fēn
ㄈㄣˊ	fén
ㄈㄣˇ	fěn
ㄈㄣˋ	fèn
˙ㄈㄥ	feng
ㄈㄥ	fēng
ㄈㄥˊ	féng
ㄈㄥˇ	fěng
ㄈㄥˋ	fèng
˙ㄈㄧㄠ	fiao
ㄈㄧㄠ	fiāo
ㄈㄧㄠˊ	fiáo
ㄈㄧㄠˇ	fiǎo
ㄈㄧㄠˋ	fiào
˙ㄈㄛ	fo
ㄈㄛ	fō
ㄈㄛˊ	fó
ㄈㄛˇ	fǒ
ㄈㄛˋ	fò
˙ㄈㄡ	fou
ㄈㄡ	fōu
ㄈㄡˊ	fóu
ㄈㄡˇ	fǒu
ㄈㄡˋ	fòu
˙ㄈㄨ	fu
ㄈㄨ	fū
ㄈㄨˊ	fú
ㄈㄨˇ	fǔ
ㄈㄨˋ	fù
˙ㄍㄚ	ga
ㄍㄚ	gā
ㄍㄚˊ	gá
ㄍㄚˇ	gǎ
ㄍㄚˋ	gà
˙ㄍㄞ	gai
ㄍㄞ	gāi
ㄍㄞˊ	gái
ㄍㄞˇ	gǎi
ㄍㄞˋ	gài
˙ㄍㄢ	gan
ㄍㄢ	gān
ㄍㄢˊ	gán
ㄍㄢˇ	gǎn
ㄍㄢˋ	gàn
˙ㄍㄤ	gang
ㄍㄤ	gāng
ㄍㄤˊ	gáng
ㄍㄤˇ	gǎng
ㄍㄤˋ	gàng
˙ㄍㄠ	gao
ㄍㄠ	gāo
ㄍㄠˊ	gáo
ㄍㄠˇ	gǎo
ㄍㄠˋ	gào
˙ㄍㄜ	ge
ㄍㄜ	gē
ㄍㄜˊ	gé
ㄍㄜˇ	gě
ㄍㄜˋ	gè
˙ㄍㄟ	gei
ㄍㄟ	gēi
ㄍㄟˊ	géi
ㄍㄟˇ	gěi
ㄍㄟˋ	gèi
˙ㄍㄣ	gen
ㄍㄣ	gēn
ㄍㄣˊ	gén
ㄍㄣˇ	gěn
ㄍㄣˋ	gèn
˙ㄍㄥ	geng
ㄍㄥ	gēng
ㄍㄥˊ	géng
ㄍㄥˇ	gěng
ㄍㄥˋ	gèng
˙ㄍㄨㄥ	gong
ㄍㄨㄥ	gōng
ㄍㄨㄥˊ	góng
ㄍㄨㄥˇ	gǒng
ㄍㄨㄥˋ	gòng
˙ㄍㄡ	gou
ㄍㄡ	gōu
ㄍㄡˊ	góu
ㄍㄡˇ	gǒu
ㄍㄡˋ	gòu
˙ㄍㄨ	gu
ㄍㄨ	gū
ㄍㄨˊ	gú
ㄍㄨˇ	gǔ
ㄍㄨˋ	gù
˙ㄍㄨㄚ	gua
ㄍㄨㄚ	guā
ㄍㄨㄚˊ	guá
ㄍㄨㄚˇ	guǎ
ㄍㄨㄚˋ	guà
˙ㄍㄨㄞ	guai
ㄍㄨㄞ	guāi
ㄍㄨㄞˊ	guái
ㄍㄨㄞˇ	guǎi
ㄍㄨㄞˋ	guài
˙ㄍㄨㄢ	guan
ㄍㄨㄢ	guān
ㄍㄨㄢˊ	guán
ㄍㄨㄢˇ	guǎn
ㄍㄨㄢˋ	guàn
˙ㄍㄨㄤ	guang
ㄍㄨㄤ	guāng
ㄍㄨㄤˊ	guáng
ㄍㄨㄤˇ	guǎng
ㄍㄨㄤˋ	guàng
˙ㄍㄨㄟ	gui
ㄍㄨㄟ	guī
ㄍㄨㄟˊ	guí
ㄍㄨㄟˇ	guǐ
ㄍㄨㄟˋ	guì
˙ㄍㄨㄣ	gun
ㄍㄨㄣ	gūn
ㄍㄨㄣˊ	gún
ㄍㄨㄣˇ	gǔn
ㄍㄨㄣˋ	gùn
˙ㄍㄨㄛ	guo
ㄍㄨㄛ	guō
ㄍㄨㄛˊ	guó
ㄍㄨㄛˇ	guǒ
ㄍㄨㄛˋ	guò
˙ㄏㄚ	ha
ㄏㄚ	hā
ㄏㄚˊ	há
ㄏㄚˇ	hǎ
ㄏㄚˋ	hà
˙ㄏㄞ	hai
ㄏㄞ	hāi
ㄏㄞˊ	hái
ㄏㄞˇ	hǎi
ㄏㄞˋ	hài
˙ㄏㄢ	han
ㄏㄢ	hān
ㄏㄢˊ	hán
ㄏㄢˇ	hǎn
ㄏㄢˋ	hàn
˙ㄏㄤ	hang
ㄏㄤ	hāng
ㄏㄤˊ	háng
ㄏㄤˇ	hǎng
ㄏㄤˋ	hàng
˙ㄏㄠ	hao
ㄏㄠ	hāo
ㄏㄠˊ	háo
ㄏㄠˇ	hǎo
ㄏㄠˋ	hào
˙ㄏㄜ	he
ㄏㄜ	hē
ㄏㄜˊ	hé
ㄏㄜˇ	hě
ㄏㄜˋ	hè
˙ㄏㄟ	hei
ㄏㄟ	hēi
ㄏㄟˊ	héi
ㄏㄟˇ	hěi
ㄏㄟˋ	hèi
˙ㄏㄣ	hen
ㄏㄣ	hēn
ㄏㄣˊ	hén
ㄏㄣˇ	hěn
ㄏㄣˋ	hèn
˙ㄏㄥ	heng
ㄏㄥ	hēng
ㄏㄥˊ	héng
ㄏㄥˇ	hěng
ㄏㄥˋ	hèng
˙ㄏㄨㄥ	hong
ㄏㄨㄥ	hōng
ㄏㄨㄥˊ	hóng
ㄏㄨㄥˇ	hǒng
ㄏㄨㄥˋ	hòng
˙ㄏㄡ	hou
ㄏㄡ	hōu
ㄏㄡˊ	hóu
ㄏㄡˇ	hǒu
ㄏㄡˋ	hòu
˙ㄏㄨ	hu
ㄏㄨ	hū
ㄏㄨˊ	hú
ㄏㄨˇ	hǔ
ㄏㄨˋ	hù
˙ㄏㄨㄚ	hua
ㄏㄨㄚ	huā
ㄏㄨㄚˊ	huá
ㄏㄨㄚˇ	huǎ
ㄏㄨㄚˋ	huà
˙ㄏㄨㄞ	huai
ㄏㄨㄞ	huāi
ㄏㄨㄞˊ	huái
ㄏㄨㄞˇ	huǎi
ㄏㄨㄞˋ	huài
˙ㄏㄨㄢ	huan
ㄏㄨㄢ	huān
ㄏㄨㄢˊ	huán
ㄏㄨㄢˇ	huǎn
ㄏㄨㄢˋ	huàn
˙ㄏㄨㄤ	huang
ㄏㄨㄤ	huāng
ㄏㄨㄤˊ	huáng
ㄏㄨㄤˇ	huǎng
ㄏㄨㄤˋ	huàng
˙ㄏㄨㄟ	hui
ㄏㄨㄟ	huī
ㄏㄨㄟˊ	huí
ㄏㄨㄟˇ	huǐ
ㄏㄨㄟˋ	huì
˙ㄏㄨㄣ	hun
ㄏㄨㄣ	hūn
ㄏㄨㄣˊ	hún
ㄏㄨㄣˇ	hǔn
ㄏㄨㄣˋ	hùn
˙ㄏㄨㄛ	huo
ㄏㄨㄛ	huō
ㄏㄨㄛˊ	huó
ㄏㄨㄛˇ	huǒ
ㄏㄨㄛˋ	huò
˙ㄐㄧ	ji
ㄐㄧ	jī
ㄐㄧˊ	jí
ㄐㄧˇ	jǐ
ㄐㄧˋ	jì
˙ㄐㄧㄚ	jia
ㄐㄧㄚ	jiā
ㄐㄧㄚˊ	jiá
ㄐㄧㄚˇ	jiǎ
ㄐㄧㄚˋ	jià
˙ㄐㄧㄢ	jian
ㄐㄧㄢ	jiān
ㄐㄧㄢˊ	jián
ㄐㄧㄢˇ	jiǎn
ㄐㄧㄢˋ	jiàn
˙ㄐㄧㄤ	jiang
ㄐㄧㄤ	jiāng
ㄐㄧㄤˊ	jiáng
ㄐㄧㄤˇ	jiǎng
ㄐㄧㄤˋ	jiàng
˙ㄐㄧㄠ	jiao
ㄐㄧㄠ	jiāo
ㄐㄧㄠˊ	jiáo
ㄐㄧㄠˇ	jiǎo
ㄐㄧㄠˋ	jiào
˙ㄐㄧㄝ	jie
ㄐㄧㄝ	jiē
ㄐㄧㄝˊ	jié
ㄐㄧㄝˇ	jiě
ㄐㄧㄝˋ	jiè
˙ㄐㄧㄣ	jin
ㄐㄧㄣ	jīn
ㄐㄧㄣˊ	jín
ㄐㄧㄣˇ	jǐn
ㄐㄧㄣˋ	jìn
˙ㄐㄧㄥ	jing
ㄐㄧㄥ	jīng
ㄐㄧㄥˊ	jíng
ㄐㄧㄥˇ	jǐng
ㄐㄧㄥˋ	jìng
˙ㄐㄩㄥ	jiong
ㄐㄩㄥ	jiōng
ㄐㄩㄥˊ	jióng
ㄐㄩㄥˇ	jiǒng
ㄐㄩㄥˋ	jiòng
˙ㄐㄧㄡ	jiu
ㄐㄧㄡ	jiū
ㄐㄧㄡˊ	jiú
ㄐㄧㄡˇ	jiǔ
ㄐㄧㄡˋ	jiù
˙ㄐㄩ	ju
ㄐㄩ	jū
ㄐㄩˊ	jú
ㄐㄩˇ	jǔ
ㄐㄩˋ	jù
˙ㄐㄩㄢ	juan
ㄐㄩㄢ	juān
ㄐㄩㄢˊ	juán
ㄐㄩㄢˇ	juǎn
ㄐㄩㄢˋ	juàn
˙ㄐㄩㄝ	jue
ㄐㄩㄝ	juē
ㄐㄩㄝˊ	jué
ㄐㄩㄝˇ	juě
ㄐㄩㄝˋ	juè
˙ㄐㄩㄣ	jun
ㄐㄩㄣ	jūn
ㄐㄩㄣˊ	jún
ㄐㄩㄣˇ	jǔn
ㄐㄩㄣˋ	jùn
˙ㄎㄚ	ka
ㄎㄚ	kā
ㄎㄚˊ	ká
ㄎㄚˇ	kǎ
ㄎㄚˋ	kà
˙ㄎㄞ	kai
ㄎㄞ	kāi
ㄎㄞˊ	kái
ㄎㄞˇ	kǎi
ㄎㄞˋ	kài
˙ㄎㄢ	kan
ㄎㄢ	kān
ㄎㄢˊ	kán
ㄎㄢˇ	kǎn
ㄎㄢˋ	kàn
˙ㄎㄤ	kang
ㄎㄤ	kāng
ㄎㄤˊ	káng
ㄎㄤˇ	kǎng
ㄎㄤˋ	kàng
˙ㄎㄠ	kao
ㄎㄠ	kāo
ㄎㄠˊ	káo
ㄎㄠˇ	kǎo
ㄎㄠˋ	kào
˙ㄎㄜ	ke
ㄎㄜ	kē
ㄎㄜˊ	ké
ㄎㄜˇ	kě
ㄎㄜˋ	kè
˙ㄎㄣ	ken
ㄎㄣ	kēn
ㄎㄣˊ	kén
ㄎㄣˇ	kěn
ㄎㄣˋ	kèn
˙ㄎㄥ	keng
ㄎㄥ	kēng
ㄎㄥˊ	kéng
ㄎㄥˇ	kěng
ㄎㄥˋ	kèng
˙ㄎㄨㄥ	kong
ㄎㄨㄥ	kōng
ㄎㄨㄥˊ	kóng
ㄎㄨㄥˇ	kǒng
ㄎㄨㄥˋ	kòng
˙ㄎㄡ	kou
ㄎㄡ	kōu
ㄎㄡˊ	kóu
ㄎㄡˇ	kǒu
ㄎㄡˋ	kòu
˙ㄎㄨ	ku
ㄎㄨ	kū
ㄎㄨˊ	kú
ㄎㄨˇ	kǔ
ㄎㄨˋ	kù
˙ㄎㄨㄚ	kua
ㄎㄨㄚ	kuā
ㄎㄨㄚˊ	kuá
ㄎㄨㄚˇ	kuǎ
ㄎㄨㄚˋ	kuà
˙ㄎㄨㄞ	kuai
ㄎㄨㄞ	kuāi
ㄎㄨㄞˊ	kuái
ㄎㄨㄞˇ	kuǎi
ㄎㄨㄞˋ	kuài
˙ㄎㄨㄢ	kuan
ㄎㄨㄢ	kuān
ㄎㄨㄢˊ	kuán
ㄎㄨㄢˇ	kuǎn
ㄎㄨㄢˋ	kuàn
˙ㄎㄨㄤ	kuang
ㄎㄨㄤ	kuāng
ㄎㄨㄤˊ	kuáng
ㄎㄨㄤˇ	kuǎng
ㄎㄨㄤˋ	kuàng
˙ㄎㄨㄟ	kui
ㄎㄨㄟ	kuī
ㄎㄨㄟˊ	kuí
ㄎㄨㄟˇ	kuǐ
ㄎㄨㄟˋ	kuì
˙ㄎㄨㄣ	kun
ㄎㄨㄣ	kūn
ㄎㄨㄣˊ	kún
ㄎㄨㄣˇ	kǔn
ㄎㄨㄣˋ	kùn
˙ㄎㄨㄛ	kuo
ㄎㄨㄛ	kuō
ㄎㄨㄛˊ	kuó
ㄎㄨㄛˇ	kuǒ
ㄎㄨㄛˋ	kuò
˙ㄌㄚ	la
ㄌㄚ	lā
ㄌㄚˊ	lá
ㄌㄚˇ	lǎ
ㄌㄚˋ	là
˙ㄌㄞ	lai
ㄌㄞ	lāi
ㄌㄞˊ	lái
ㄌㄞˇ	lǎi
ㄌㄞˋ	lài
˙ㄌㄢ	lan
ㄌㄢ	lān
ㄌㄢˊ	lán
ㄌㄢˇ	lǎn
ㄌㄢˋ	làn
˙ㄌㄤ	lang
ㄌㄤ	lāng
ㄌㄤˊ	láng
ㄌㄤˇ	lǎng
ㄌㄤˋ	làng
˙ㄌㄠ	lao
ㄌㄠ	lāo
ㄌㄠˊ	láo
ㄌㄠˇ	lǎo
ㄌㄠˋ	lào
˙ㄌㄜ	le
ㄌㄜ	lē
ㄌㄜˊ	lé
ㄌㄜˇ	lě
ㄌㄜˋ	lè
˙ㄌㄟ	lei
ㄌㄟ	lēi
ㄌㄟˊ	léi
ㄌㄟˇ	lěi
ㄌㄟˋ	lèi
˙ㄌㄥ	leng
ㄌㄥ	lēng
ㄌㄥˊ	léng
ㄌㄥˇ	lěng
ㄌㄥˋ	lèng
˙ㄌㄧ	li
ㄌㄧ	lī
ㄌㄧˊ	lí
ㄌㄧˇ	lǐ
ㄌㄧˋ	lì
˙ㄌㄧㄚ	lia
ㄌㄧㄚ	liā
ㄌㄧㄚˊ	liá
ㄌㄧㄚˇ	liǎ
ㄌㄧㄚˋ	lià
˙ㄌㄧㄢ	lian
ㄌㄧㄢ	liān
ㄌㄧㄢˊ	lián
ㄌㄧㄢˇ	liǎn
ㄌㄧㄢˋ	liàn
˙ㄌㄧㄤ	liang
ㄌㄧㄤ	liāng
ㄌㄧㄤˊ	liáng
ㄌㄧㄤˇ	liǎng
ㄌㄧㄤˋ	liàng
˙ㄌㄧㄠ	liao
ㄌㄧㄠ	liāo
ㄌㄧㄠˊ	liáo
ㄌㄧㄠˇ	liǎo
ㄌㄧㄠˋ	liào
˙ㄌㄧㄝ	lie
ㄌㄧㄝ	liē
ㄌㄧㄝˊ	lié
ㄌㄧㄝˇ	liě
ㄌㄧㄝˋ	liè
˙ㄌㄧㄣ	lin
ㄌㄧㄣ	līn
ㄌㄧㄣˊ	lín
ㄌㄧㄣˇ	lǐn
ㄌㄧㄣˋ	lìn
˙ㄌㄧㄥ	ling
ㄌㄧㄥ	līng
ㄌㄧㄥˊ	líng
ㄌㄧㄥˇ	lǐng
ㄌㄧㄥˋ	lìng
˙ㄌㄧㄡ	liu
ㄌㄧㄡ	liū
ㄌㄧㄡˊ	liú
ㄌㄧㄡˇ	liǔ
ㄌㄧㄡˋ	liù
˙ㄌㄛ	lo
ㄌㄛ	lō
ㄌㄛˊ	ló
ㄌㄛˇ	lǒ
ㄌㄛˋ	lò
˙ㄌㄨㄥ	long
ㄌㄨㄥ	lōng
ㄌㄨㄥˊ	lóng
ㄌㄨㄥˇ	lǒng
ㄌㄨㄥˋ	lòng
˙ㄌㄡ	lou
ㄌㄡ	lōu
ㄌㄡˊ	lóu
ㄌㄡˇ	lǒu
ㄌㄡˋ	lòu
˙ㄌㄨ	lu
ㄌㄨ	lū
ㄌㄨˊ	lú
ㄌㄨˇ	lǔ
ㄌㄨˋ	lù
˙ㄌㄨㄢ	luan
ㄌㄨㄢ	luān
ㄌㄨㄢˊ	luán
ㄌㄨㄢˇ	luǎn
ㄌㄨㄢˋ	luàn
˙ㄌㄨㄣ	lun
ㄌㄨㄣ	lūn
ㄌㄨㄣˊ	lún
ㄌㄨㄣˇ	lǔn
ㄌㄨㄣˋ	lùn
˙ㄌㄨㄛ	luo
ㄌㄨㄛ	luō
ㄌㄨㄛˊ	luó
ㄌㄨㄛˇ	luǒ
ㄌㄨㄛˋ	luò
˙ㄌㄩ	lü
ㄌㄩ	lǖ
ㄌㄩˊ	lǘ
ㄌㄩˇ	lǚ
ㄌㄩˋ	lǜ
˙ㄌㄩㄝ	lüe
ㄌㄩㄝ	lüē
ㄌㄩㄝˊ	lüé
ㄌㄩㄝˇ	lüě
ㄌㄩㄝˋ	lüè
˙ㄇ	m
ㄇ	m̄
ㄇˊ	ḿ
ㄇˇ	m̌
ㄇˋ	m̀
˙ㄇㄚ	ma
ㄇㄚ	mā
ㄇㄚˊ	má
ㄇㄚˇ	mǎ
ㄇㄚˋ	mà
˙ㄇㄞ	mai
ㄇㄞ	māi
ㄇㄞˊ	mái
ㄇㄞˇ	mǎi
ㄇㄞˋ	mài
˙ㄇㄢ	man
ㄇㄢ	mān
ㄇㄢˊ	mán
ㄇㄢˇ	mǎn
ㄇㄢˋ	màn
˙ㄇㄤ	mang
ㄇㄤ	māng
ㄇㄤˊ	máng
ㄇㄤˇ	mǎng
ㄇㄤˋ	màng
˙ㄇㄠ	mao
ㄇㄠ	māo
ㄇㄠˊ	máo
ㄇㄠˇ	mǎo
ㄇㄠˋ	mào
˙ㄇㄜ	me
ㄇㄜ	mē
ㄇㄜˊ	mé
ㄇㄜˇ	mě
ㄇㄜˋ	mè
˙ㄇㄟ	mei
ㄇㄟ	mēi
ㄇㄟˊ	méi
ㄇㄟˇ	měi
ㄇㄟˋ	mèi
˙ㄇㄣ	men
ㄇㄣ	mēn
ㄇㄣˊ	mén
ㄇㄣˇ	měn
ㄇㄣˋ	mèn
˙ㄇㄥ	meng
ㄇㄥ	mēng
ㄇㄥˊ	méng
ㄇㄥˇ	měng
ㄇㄥˋ	mèng
˙ㄇㄧ	mi
ㄇㄧ	mī
ㄇㄧˊ	mí
ㄇㄧˇ	mǐ
ㄇㄧˋ	mì
˙ㄇㄧㄢ	mian
ㄇㄧㄢ	miān
ㄇㄧㄢˊ	mián
ㄇㄧㄢˇ	miǎn
ㄇㄧㄢˋ	miàn
˙ㄇㄧㄠ	miao
ㄇㄧㄠ	miāo
ㄇㄧㄠˊ	miáo
ㄇㄧㄠˇ	miǎo
ㄇㄧㄠˋ	miào
˙ㄇㄧㄝ	mie
ㄇㄧㄝ	miē
ㄇㄧㄝˊ	mié
ㄇㄧㄝˇ	miě
ㄇㄧㄝˋ	miè
˙ㄇㄧㄣ	min
ㄇㄧㄣ	mīn
ㄇㄧㄣˊ	mín
ㄇㄧㄣˇ	mǐn
ㄇㄧㄣˋ	mìn
˙ㄇㄧㄥ	ming
ㄇㄧㄥ	mīng
ㄇㄧㄥˊ	míng
ㄇㄧㄥˇ	mǐng
ㄇㄧㄥˋ	mìng
˙ㄇㄧㄡ	miu
ㄇㄧㄡ	miū
ㄇㄧㄡˊ	miú
ㄇㄧㄡˇ	miǔ
ㄇㄧㄡˋ	miù
˙ㄇㄛ	mo
ㄇㄛ	mō
ㄇㄛˊ	mó
ㄇㄛˇ	mǒ
ㄇㄛˋ	mò
˙ㄇㄡ	mou
ㄇㄡ	mōu
ㄇㄡˊ	móu
ㄇㄡˇ	mǒu
ㄇㄡˋ	mòu
˙ㄇㄨ	mu
ㄇㄨ	mū
ㄇㄨˊ	mú
ㄇㄨˇ	mǔ
ㄇㄨˋ	mù
˙ㄋㄚ	na
ㄋㄚ	nā
ㄋㄚˊ	ná
ㄋㄚˇ	nǎ
ㄋㄚˋ	nà
˙ㄋㄞ	nai
ㄋㄞ	nāi
ㄋㄞˊ	nái
ㄋㄞˇ	nǎi
ㄋㄞˋ	nài
˙ㄋㄢ	nan
ㄋㄢ	nān
ㄋㄢˊ	nán
ㄋㄢˇ	nǎn
ㄋㄢˋ	nàn
˙ㄋㄤ	nang
ㄋㄤ	nāng
ㄋㄤˊ	náng
ㄋㄤˇ	nǎng
ㄋㄤˋ	nàng
˙ㄋㄠ	nao
ㄋㄠ	nāo
ㄋㄠˊ	náo
ㄋㄠˇ	nǎo
ㄋㄠˋ	nào
˙ㄋㄜ	ne
ㄋㄜ	nē
ㄋㄜˊ	né
ㄋㄜˇ	ně
ㄋㄜˋ	nè
˙ㄋㄟ	nei
ㄋㄟ	nēi
ㄋㄟˊ	néi
ㄋㄟˇ	něi
ㄋㄟˋ	nèi
˙ㄋㄣ	nen
ㄋㄣ	nēn
ㄋㄣˊ	nén
ㄋㄣˇ	něn
ㄋㄣˋ	nèn
˙ㄋㄥ	neng
ㄋㄥ	nēng
ㄋㄥˊ	néng
ㄋㄥˇ	něng
ㄋㄥˋ	nèng
˙ㄋㄧ	ni
ㄋㄧ	nī
ㄋㄧˊ	ní
ㄋㄧˇ	nǐ
ㄋㄧˋ	nì
˙ㄋㄧㄢ	nian
ㄋㄧㄢ	niān
ㄋㄧㄢˊ	nián
ㄋㄧㄢˇ	niǎn
ㄋㄧㄢˋ	niàn
˙ㄋㄧㄤ	niang
ㄋㄧㄤ	niāng
ㄋㄧㄤˊ	niáng
ㄋㄧㄤˇ	niǎng
ㄋㄧㄤˋ	niàng
˙ㄋㄧㄠ	niao
ㄋㄧㄠ	niāo
ㄋㄧㄠˊ	niáo
ㄋㄧㄠˇ	niǎo
ㄋㄧㄠˋ	niào
˙ㄋㄧㄝ	nie
ㄋㄧㄝ	niē
ㄋㄧㄝˊ	nié
ㄋㄧㄝˇ	niě
ㄋㄧㄝˋ	niè
˙ㄋㄧㄣ	nin
ㄋㄧㄣ	nīn
ㄋㄧㄣˊ	nín
ㄋㄧㄣˇ	nǐn
ㄋㄧㄣˋ	nìn
˙ㄋㄧㄥ	ning
ㄋㄧㄥ	nīng
ㄋㄧㄥˊ	níng
ㄋㄧㄥˇ	nǐng
ㄋㄧㄥˋ	nìng
˙ㄋㄧㄡ	niu
ㄋㄧㄡ	niū
ㄋㄧㄡˊ	niú
ㄋㄧㄡˇ	niǔ
ㄋㄧㄡˋ	niù
˙ㄋㄨㄥ	nong
ㄋㄨㄥ	nōng
ㄋㄨㄥˊ	nóng
ㄋㄨㄥˇ	nǒng
ㄋㄨㄥˋ	nòng
˙ㄋㄡ	nou
ㄋㄡ	nōu
ㄋㄡˊ	nóu
ㄋㄡˇ	nǒu
ㄋㄡˋ	nòu
˙ㄋㄨ	nu
ㄋㄨ	nū
ㄋㄨˊ	nú
ㄋㄨˇ	nǔ
ㄋㄨˋ	nù
˙ㄋㄨㄢ	nuan
ㄋㄨㄢ	nuān
ㄋㄨㄢˊ	nuán
ㄋㄨㄢˇ	nuǎn
ㄋㄨㄢˋ	nuàn
˙ㄋㄨㄛ	nuo
ㄋㄨㄛ	nuō
ㄋㄨㄛˊ	nuó
ㄋㄨㄛˇ	nuǒ
ㄋㄨㄛˋ	nuò
˙ㄋㄩ	nü
ㄋㄩ	nǖ
ㄋㄩˊ	nǘ
ㄋㄩˇ	nǚ
ㄋㄩˋ	nǜ
˙ㄋㄩㄝ	nüe
ㄋㄩㄝ	nüē
ㄋㄩㄝˊ	nüé
ㄋㄩㄝˇ	nüě
ㄋㄩㄝˋ	nüè
˙ㄛ	o
ㄛ	ō
ㄛˊ	ó
ㄛˇ	ǒ
ㄛˋ	ò
˙ㄡ	ou
ㄡ	ōu
ㄡˊ	óu
ㄡˇ	ǒu
ㄡˋ	òu
˙ㄆㄚ	pa
ㄆㄚ	pā
ㄆㄚˊ	pá
ㄆㄚˇ	pǎ
ㄆㄚˋ	pà
˙ㄆㄞ	pai
ㄆㄞ	pāi
ㄆㄞˊ	pái
ㄆㄞˇ	pǎi
ㄆㄞˋ	pài
˙ㄆㄢ	pan
ㄆㄢ	pān
ㄆㄢˊ	pán
ㄆㄢˇ	pǎn
ㄆㄢˋ	pàn
˙ㄆㄤ	pang
ㄆㄤ	pāng
ㄆㄤˊ	páng
ㄆㄤˇ	pǎng
ㄆㄤˋ	pàng
˙ㄆㄠ	pao
ㄆㄠ	pāo
ㄆㄠˊ	páo
ㄆㄠˇ	pǎo
ㄆㄠˋ	pào
˙ㄆㄟ	pei
ㄆㄟ	pēi
ㄆㄟˊ	péi
ㄆㄟˇ	pěi
ㄆㄟˋ	pèi
˙ㄆㄣ	pen
ㄆㄣ	pēn
ㄆㄣˊ	pén
ㄆㄣˇ	pěn
ㄆㄣˋ	pèn
˙ㄆㄥ	peng
ㄆㄥ	pēng
ㄆㄥˊ	péng
ㄆㄥˇ	pěng
ㄆㄥˋ	pèng
˙ㄆㄧ	pi
ㄆㄧ	pī
ㄆㄧˊ	pí
ㄆㄧˇ	pǐ
ㄆㄧˋ	pì
˙ㄆㄧㄢ	pian
ㄆㄧㄢ	piān
ㄆㄧㄢˊ	pián
ㄆㄧㄢˇ	piǎn
ㄆㄧㄢˋ	piàn
˙ㄆㄧㄠ	piao
ㄆㄧㄠ	piāo
ㄆㄧㄠˊ	piáo
ㄆㄧㄠˇ	piǎo
ㄆㄧㄠˋ	piào
˙ㄆㄧㄝ	pie
ㄆㄧㄝ	piē
ㄆㄧㄝˊ	pié
ㄆㄧㄝˇ	piě
ㄆㄧㄝˋ	piè
˙ㄆㄧㄣ	pin
ㄆㄧㄣ	pīn
ㄆㄧㄣˊ	pín
ㄆㄧㄣˇ	pǐn
ㄆㄧㄣˋ	pìn
˙ㄆㄧㄥ	ping
ㄆㄧㄥ	pīng
ㄆㄧㄥˊ	píng
ㄆㄧㄥˇ	pǐng
ㄆㄧㄥˋ	pìng
˙ㄆㄛ	po
ㄆㄛ	pō
ㄆㄛˊ	pó
ㄆㄛˇ	pǒ
ㄆㄛˋ	pò
˙ㄆㄡ	pou
ㄆㄡ	pōu
ㄆㄡˊ	póu
ㄆㄡˇ	pǒu
ㄆㄡˋ	pòu
˙ㄆㄨ	pu
ㄆㄨ	pū
ㄆㄨˊ	pú
ㄆㄨˇ	pǔ
ㄆㄨˋ	pù
˙ㄑㄧ	qi
ㄑㄧ	qī
ㄑㄧˊ	qí
ㄑㄧˇ	qǐ
ㄑㄧˋ	qì
˙ㄑㄧㄚ	qia
ㄑㄧㄚ	qiā
ㄑㄧㄚˊ	qiá
ㄑㄧㄚˇ	qiǎ
ㄑㄧㄚˋ	qià
˙ㄑㄧㄢ	qian
ㄑㄧㄢ	qiān
ㄑㄧㄢˊ	qián
ㄑㄧㄢˇ	qiǎn
ㄑㄧㄢˋ	qiàn
˙ㄑㄧㄤ	qiang
ㄑㄧㄤ	qiāng
ㄑㄧㄤˊ	qiáng
ㄑㄧㄤˇ	qiǎng
ㄑㄧㄤˋ	qiàng
˙ㄑㄧㄠ	qiao
ㄑㄧㄠ	qiāo
ㄑㄧㄠˊ	qiáo
ㄑㄧㄠˇ	qiǎo
ㄑㄧㄠˋ	qiào
˙ㄑㄧㄝ	qie
ㄑㄧㄝ	qiē
ㄑㄧㄝˊ	qié
ㄑㄧㄝˇ	qiě
ㄑㄧㄝˋ	qiè
˙ㄑㄧㄣ	qin
ㄑㄧㄣ	qīn
ㄑㄧㄣˊ	qín
ㄑㄧㄣˇ	qǐn
ㄑㄧㄣˋ	qìn
˙ㄑㄧㄥ	qing
ㄑㄧㄥ	qīng
ㄑㄧㄥˊ	qíng
ㄑㄧㄥˇ	qǐng
ㄑㄧㄥˋ	qìng
˙ㄑㄩㄥ	qiong
ㄑㄩㄥ	qiōng
ㄑㄩㄥˊ	qióng
ㄑㄩㄥˇ	qiǒng
ㄑㄩㄥˋ	qiòng
˙ㄑㄧㄡ	qiu
ㄑㄧㄡ	qiū
ㄑㄧㄡˊ	qiú
ㄑㄧㄡˇ	qiǔ
ㄑㄧㄡˋ	qiù
˙ㄑㄩ	qu
ㄑㄩ	qū
ㄑㄩˊ	qú
ㄑㄩˇ	qǔ
ㄑㄩˋ	qù
˙ㄑㄩㄢ	quan
ㄑㄩㄢ	quān
ㄑㄩㄢˊ	quán
ㄑㄩㄢˇ	quǎn
ㄑㄩㄢˋ	quàn
˙ㄑㄩㄝ	que
ㄑㄩㄝ	quē
ㄑㄩㄝˊ	qué
ㄑㄩㄝˇ	quě
ㄑㄩㄝˋ	què
˙ㄑㄩㄣ	qun
ㄑㄩㄣ	qūn
ㄑㄩㄣˊ	qún
ㄑㄩㄣˇ	qǔn
ㄑㄩㄣˋ	qùn
ㄦ	r ēr
˙ㄖㄢ	ran
ㄖㄢ	rān
ㄖㄢˊ	rán
ㄖㄢˇ	rǎn
ㄖㄢˋ	ràn
˙ㄖㄤ	rang
ㄖㄤ	rāng
ㄖㄤˊ	ráng
ㄖㄤˇ	rǎng
ㄖㄤˋ	ràng
˙ㄖㄠ	rao
ㄖㄠ	rāo
ㄖㄠˊ	ráo
ㄖㄠˇ	rǎo
ㄖㄠˋ	rào
˙ㄖㄜ	re
ㄖㄜ	rē
ㄖㄜˊ	ré
ㄖㄜˇ	rě
ㄖㄜˋ	rè
˙ㄖㄣ	ren
ㄖㄣ	rēn
ㄖㄣˊ	rén
ㄖㄣˇ	rěn
ㄖㄣˋ	rèn
˙ㄖㄥ	reng
ㄖㄥ	rēng
ㄖㄥˊ	réng
ㄖㄥˇ	rěng
ㄖㄥˋ	rèng
˙ㄖ	ri
ㄖ	rī
ㄖˊ	rí
ㄖˇ	rǐ
ㄖˋ	rì
˙ㄖㄨㄥ	rong
ㄖㄨㄥ	rōng
ㄖㄨㄥˊ	róng
ㄖㄨㄥˇ	rǒng
ㄖㄨㄥˋ	ròng
˙ㄖㄡ	rou
ㄖㄡ	rōu
ㄖㄡˊ	róu
ㄖㄡˇ	rǒu
ㄖㄡˋ	ròu
˙ㄖㄨ	ru
ㄖㄨ	rū
ㄖㄨˊ	rú
ㄖㄨˇ	rǔ
ㄖㄨˋ	rù
˙ㄖㄨㄢ	ruan
ㄖㄨㄢ	ruān
ㄖㄨㄢˊ	ruán
ㄖㄨㄢˇ	ruǎn
ㄖㄨㄢˋ	ruàn
˙ㄖㄨㄟ	rui
ㄖㄨㄟ	ruī
ㄖㄨㄟˊ	ruí
ㄖㄨㄟˇ	ruǐ
ㄖㄨㄟˋ	ruì
˙ㄖㄨㄣ	run
ㄖㄨㄣ	rūn
ㄖㄨㄣˊ	rún
ㄖㄨㄣˇ	rǔn
ㄖㄨㄣˋ	rùn
˙ㄖㄨㄛ	ruo
ㄖㄨㄛ	ruō
ㄖㄨㄛˊ	ruó
ㄖㄨㄛˇ	ruǒ
ㄖㄨㄛˋ	ruò
˙ㄙㄚ	sa
ㄙㄚ	sā
ㄙㄚˊ	sá
ㄙㄚˇ	sǎ
ㄙㄚˋ	sà
˙ㄙㄞ	sai
ㄙㄞ	sāi
ㄙㄞˊ	sái
ㄙㄞˇ	sǎi
ㄙㄞˋ	sài
˙ㄙㄢ	san
ㄙㄢ	sān
ㄙㄢˊ	sán
ㄙㄢˇ	sǎn
ㄙㄢˋ	sàn
˙ㄙㄤ	sang
ㄙㄤ	sāng
ㄙㄤˊ	sáng
ㄙㄤˇ	sǎng
ㄙㄤˋ	sàng
˙ㄙㄠ	sao
ㄙㄠ	sāo
ㄙㄠˊ	sáo
ㄙㄠˇ	sǎo
ㄙㄠˋ	sào
˙ㄙㄜ	se
ㄙㄜ	sē
ㄙㄜˊ	sé
ㄙㄜˇ	sě
ㄙㄜˋ	sè
˙ㄙㄣ	sen
ㄙㄣ	sēn
ㄙㄣˊ	sén
ㄙㄣˇ	sěn
ㄙㄣˋ	sèn
˙ㄙㄥ	seng
ㄙㄥ	sēng
ㄙㄥˊ	séng
ㄙㄥˇ	sěng
ㄙㄥˋ	sèng
˙ㄕㄚ	sha
ㄕㄚ	shā
ㄕㄚˊ	shá
ㄕㄚˇ	shǎ
ㄕㄚˋ	shà
˙ㄕㄞ	shai
ㄕㄞ	shāi
ㄕㄞˊ	shái
ㄕㄞˇ	shǎi
ㄕㄞˋ	shài
˙ㄕㄢ	shan
ㄕㄢ	shān
ㄕㄢˊ	shán
ㄕㄢˇ	shǎn
ㄕㄢˋ	shàn
˙ㄕㄤ	shang
ㄕㄤ	shāng
ㄕㄤˊ	sháng
ㄕㄤˇ	shǎng
ㄕㄤˋ	shàng
˙ㄕㄠ	shao
ㄕㄠ	shāo
ㄕㄠˊ	sháo
ㄕㄠˇ	shǎo
ㄕㄠˋ	shào
˙ㄕㄜ	she
ㄕㄜ	shē
ㄕㄜˊ	shé
ㄕㄜˇ	shě
ㄕㄜˋ	shè
˙ㄕㄟ	shei
ㄕㄟ	shēi
ㄕㄟˊ	shéi
ㄕㄟˇ	shěi
ㄕㄟˋ	shèi
˙ㄕㄣ	shen
ㄕㄣ	shēn
ㄕㄣˊ	shén
ㄕㄣˇ	shěn
ㄕㄣˋ	shèn
˙ㄕㄥ	sheng
ㄕㄥ	shēng
ㄕㄥˊ	shéng
ㄕㄥˇ	shěng
ㄕㄥˋ	shèng
˙ㄕ	shi
ㄕ	shī
ㄕˊ	shí
ㄕˇ	shǐ
ㄕˋ	shì
˙ㄕㄡ	shou
ㄕㄡ	shōu
ㄕㄡˊ	shóu
ㄕㄡˇ	shǒu
ㄕㄡˋ	shòu
˙ㄕㄨ	shu
ㄕㄨ	shū
ㄕㄨˊ	shú
ㄕㄨˇ	shǔ
ㄕㄨˋ	shù
˙ㄕㄨㄚ	shua
ㄕㄨㄚ	shuā
ㄕㄨㄚˊ	shuá
ㄕㄨㄚˇ	shuǎ
ㄕㄨㄚˋ	shuà
˙ㄕㄨㄞ	shuai
ㄕㄨㄞ	shuāi
ㄕㄨㄞˊ	shuái
ㄕㄨㄞˇ	shuǎi
ㄕㄨㄞˋ	shuài
˙ㄕㄨㄢ	shuan
ㄕㄨㄢ	shuān
ㄕㄨㄢˊ	shuán
ㄕㄨㄢˇ	shuǎn
ㄕㄨㄢˋ	shuàn
˙ㄕㄨㄤ	shuang
ㄕㄨㄤ	shuāng
ㄕㄨㄤˊ	shuáng
ㄕㄨㄤˇ	shuǎng
ㄕㄨㄤˋ	shuàng
˙ㄕㄨㄟ	shui
ㄕㄨㄟ	shuī
ㄕㄨㄟˊ	shuí
ㄕㄨㄟˇ	shuǐ
ㄕㄨㄟˋ	shuì
˙ㄕㄨㄣ	shun
ㄕㄨㄣ	shūn
ㄕㄨㄣˊ	shún
ㄕㄨㄣˇ	shǔn
ㄕㄨㄣˋ	shùn
˙ㄕㄨㄛ	shuo
ㄕㄨㄛ	shuō
ㄕㄨㄛˊ	shuó
ㄕㄨㄛˇ	shuǒ
ㄕㄨㄛˋ	shuò
˙ㄙ	si
ㄙ	sī
ㄙˊ	sí
ㄙˇ	sǐ
ㄙˋ	sì
˙ㄙㄨㄥ	song
ㄙㄨㄥ	sōng
ㄙㄨㄥˊ	sóng
ㄙㄨㄥˇ	sǒng
ㄙㄨㄥˋ	sòng
˙ㄙㄡ	sou
ㄙㄡ	sōu
ㄙㄡˊ	sóu
ㄙㄡˇ	sǒu
ㄙㄡˋ	sòu
˙ㄙㄨ	su
ㄙㄨ	sū
ㄙㄨˊ	sú
ㄙㄨˇ	sǔ
ㄙㄨˋ	sù
˙ㄙㄨㄢ	suan
ㄙㄨㄢ	suān
ㄙㄨㄢˊ	suán
ㄙㄨㄢˇ	suǎn
ㄙㄨㄢˋ	suàn
˙ㄙㄨㄟ	sui
ㄙㄨㄟ	suī
ㄙㄨㄟˊ	suí
ㄙㄨㄟˇ	suǐ
ㄙㄨㄟˋ	suì
˙ㄙㄨㄣ	sun
ㄙㄨㄣ	sūn
ㄙㄨㄣˊ	sún
ㄙㄨㄣˇ	sǔn
ㄙㄨㄣˋ	sùn
˙ㄙㄨㄛ	suo
ㄙㄨㄛ	suō
ㄙㄨㄛˊ	suó
ㄙㄨㄛˇ	suǒ
ㄙㄨㄛˋ	suò
˙ㄊㄚ	ta
ㄊㄚ	tā
ㄊㄚˊ	tá
ㄊㄚˇ	tǎ
ㄊㄚˋ	tà
˙ㄊㄞ	tai
ㄊㄞ	tāi
ㄊㄞˊ	tái
ㄊㄞˇ	tǎi
ㄊㄞˋ	tài
˙ㄊㄢ	tan
ㄊㄢ	tān
ㄊㄢˊ	tán
ㄊㄢˇ	tǎn
ㄊㄢˋ	tàn
˙ㄊㄤ	tang
ㄊㄤ	tāng
ㄊㄤˊ	táng
ㄊㄤˇ	tǎng
ㄊㄤˋ	tàng
˙ㄊㄠ	tao
ㄊㄠ	tāo
ㄊㄠˊ	táo
ㄊㄠˇ	tǎo
ㄊㄠˋ	tào
˙ㄊㄜ	te
ㄊㄜ	tē
ㄊㄜˊ	té
ㄊㄜˇ	tě
ㄊㄜˋ	tè
˙ㄊㄥ	teng
ㄊㄥ	tēng
ㄊㄥˊ	téng
ㄊㄥˇ	těng
ㄊㄥˋ	tèng
˙ㄊㄧ	ti
ㄊㄧ	tī
ㄊㄧˊ	tí
ㄊㄧˇ	tǐ
ㄊㄧˋ	tì
˙ㄊㄧㄢ	tian
ㄊㄧㄢ	tiān
ㄊㄧㄢˊ	tián
ㄊㄧㄢˇ	tiǎn
ㄊㄧㄢˋ	tiàn
˙ㄊㄧㄠ	tiao
ㄊㄧㄠ	tiāo
ㄊㄧㄠˊ	tiáo
ㄊㄧㄠˇ	tiǎo
ㄊㄧㄠˋ	tiào
˙ㄊㄧㄝ	tie
ㄊㄧㄝ	tiē
ㄊㄧㄝˊ	tié
ㄊㄧㄝˇ	tiě
ㄊㄧㄝˋ	tiè
˙ㄊㄧㄥ	ting
ㄊㄧㄥ	tīng
ㄊㄧㄥˊ	tíng
ㄊㄧㄥˇ	tǐng
ㄊㄧㄥˋ	tìng
˙ㄊㄨㄥ	tong
ㄊㄨㄥ	tōng
ㄊㄨㄥˊ	tóng
ㄊㄨㄥˇ	tǒng
ㄊㄨㄥˋ	tòng
˙ㄊㄡ	tou
ㄊㄡ	tōu
ㄊㄡˊ	tóu
ㄊㄡˇ	tǒu
ㄊㄡˋ	tòu
˙ㄊㄨ	tu
ㄊㄨ	tū
ㄊㄨˊ	tú
ㄊㄨˇ	tǔ
ㄊㄨˋ	tù
˙ㄊㄨㄢ	tuan
ㄊㄨㄢ	tuān
ㄊㄨㄢˊ	tuán
ㄊㄨㄢˇ	tuǎn
ㄊㄨㄢˋ	tuàn
˙ㄊㄨㄟ	tui
ㄊㄨㄟ	tuī
ㄊㄨㄟˊ	tuí
ㄊㄨㄟˇ	tuǐ
ㄊㄨㄟˋ	tuì
˙ㄊㄨㄣ	tun
ㄊㄨㄣ	tūn
ㄊㄨㄣˊ	tún
ㄊㄨㄣˇ	tǔn
ㄊㄨㄣˋ	tùn
˙ㄊㄨㄛ	tuo
ㄊㄨㄛ	tuō
ㄊㄨㄛˊ	tuó
ㄊㄨㄛˇ	tuǒ
ㄊㄨㄛˋ	tuò
˙ㄨㄚ	wa
ㄨㄚ	wā
ㄨㄚˊ	wá
ㄨㄚˇ	wǎ
ㄨㄚˋ	wà
˙ㄨㄞ	wai
ㄨㄞ	wāi
ㄨㄞˊ	wái
ㄨㄞˇ	wǎi
ㄨㄞˋ	wài
˙ㄨㄢ	wan
ㄨㄢ	wān
ㄨㄢˊ	wán
ㄨㄢˇ	wǎn
ㄨㄢˋ	wàn
˙ㄨㄤ	wang
ㄨㄤ	wāng
ㄨㄤˊ	wáng
ㄨㄤˇ	wǎng
ㄨㄤˋ	wàng
˙ㄨㄟ	wei
ㄨㄟ	wēi
ㄨㄟˊ	wéi
ㄨㄟˇ	wěi
ㄨㄟˋ	wèi
˙ㄨㄣ	wen
ㄨㄣ	wēn
ㄨㄣˊ	wén
ㄨㄣˇ	wěn
ㄨㄣˋ	wèn
˙ㄨㄥ	weng
ㄨㄥ	wēng
ㄨㄥˊ	wéng
ㄨㄥˇ	wěng
ㄨㄥˋ	wèng
˙ㄨㄛ	wo
ㄨㄛ	wō
ㄨㄛˊ	wó
ㄨㄛˇ	wǒ
ㄨㄛˋ	wò
˙ㄨ	wu
ㄨ	wū
ㄨˊ	wú
ㄨˇ	wǔ
ㄨˋ	wù
˙ㄒㄧ	xi
ㄒㄧ	xī
ㄒㄧˊ	xí
ㄒㄧˇ	xǐ
ㄒㄧˋ	xì
˙ㄒㄧㄚ	xia
ㄒㄧㄚ	xiā
ㄒㄧㄚˊ	xiá
ㄒㄧㄚˇ	xiǎ
ㄒㄧㄚˋ	xià
˙ㄒㄧㄢ	xian
ㄒㄧㄢ	xiān
ㄒㄧㄢˊ	xián
ㄒㄧㄢˇ	xiǎn
ㄒㄧㄢˋ	xiàn
˙ㄒㄧㄤ	xiang
ㄒㄧㄤ	xiāng
ㄒㄧㄤˊ	xiáng
ㄒㄧㄤˇ	xiǎng
ㄒㄧㄤˋ	xiàng
˙ㄒㄧㄠ	xiao
ㄒㄧㄠ	xiāo
ㄒㄧㄠˊ	xiáo
ㄒㄧㄠˇ	xiǎo
ㄒㄧㄠˋ	xiào
˙ㄒㄧㄝ	xie
ㄒㄧㄝ	xiē
ㄒㄧㄝˊ	xié
ㄒㄧㄝˇ	xiě
ㄒㄧㄝˋ	xiè
˙ㄒㄧㄣ	xin
ㄒㄧㄣ	xīn
ㄒㄧㄣˊ	xín
ㄒㄧㄣˇ	xǐn
ㄒㄧㄣˋ	xìn
˙ㄒㄧㄥ	xing
ㄒㄧㄥ	xīng
ㄒㄧㄥˊ	xíng
ㄒㄧㄥˇ	xǐng
ㄒㄧㄥˋ	xìng
˙ㄒㄩㄥ	xiong
ㄒㄩㄥ	xiōng
ㄒㄩㄥˊ	xióng
ㄒㄩㄥˇ	xiǒng
ㄒㄩㄥˋ	xiòng
˙ㄒㄧㄡ	xiu
ㄒㄧㄡ	xiū
ㄒㄧㄡˊ	xiú
ㄒㄧㄡˇ	xiǔ
ㄒㄧㄡˋ	xiù
˙ㄒㄩ	xu
ㄒㄩ	xū
ㄒㄩˊ	xú
ㄒㄩˇ	xǔ
ㄒㄩˋ	xù
˙ㄒㄩㄢ	xuan
ㄒㄩㄢ	xuān
ㄒㄩㄢˊ	xuán
ㄒㄩㄢˇ	xuǎn
ㄒㄩㄢˋ	xuàn
˙ㄒㄩㄝ	xue
ㄒㄩㄝ	xuē
ㄒㄩㄝˊ	xué
ㄒㄩㄝˇ	xuě
ㄒㄩㄝˋ	xuè
˙ㄒㄩㄣ	xun
ㄒㄩㄣ	xūn
ㄒㄩㄣˊ	xún
ㄒㄩㄣˇ	xǔn
ㄒㄩㄣˋ	xùn
˙ㄧㄚ	ya
ㄧㄚ	yā
ㄧㄚˊ	yá
ㄧㄚˇ	yǎ
ㄧㄚˋ	yà
˙ㄧㄞ	yai
ㄧㄞ	yāi
ㄧㄞˊ	yái
ㄧㄞˇ	yǎi
ㄧㄞˋ	yài
˙ㄧㄢ	yan
ㄧㄢ	yān
ㄧㄢˊ	yán
ㄧㄢˇ	yǎn
ㄧㄢˋ	yàn
˙ㄧㄤ	yang
ㄧㄤ	yāng
ㄧㄤˊ	yáng
ㄧㄤˇ	yǎng
ㄧㄤˋ	yàng
˙ㄧㄠ	yao
ㄧㄠ	yāo
ㄧㄠˊ	yáo
ㄧㄠˇ	yǎo
ㄧㄠˋ	yào
˙ㄧㄝ	ye
ㄧㄝ	yē
ㄧㄝˊ	yé
ㄧㄝˇ	yě
ㄧㄝˋ	yè
˙ㄧ	yi
ㄧ	yī
ㄧˊ	yí
ㄧˇ	yǐ
ㄧˋ	yì
˙ㄧㄣ	yin
ㄧㄣ	yīn
ㄧㄣˊ	yín
ㄧㄣˇ	yǐn
ㄧㄣˋ	yìn
˙ㄧㄥ	ying
ㄧㄥ	yīng
ㄧㄥˊ	yíng
ㄧㄥˇ	yǐng
ㄧㄥˋ	yìng
˙ㄧㄛ	yo
ㄧㄛ	yō
ㄧㄛˊ	yó
ㄧㄛˇ	yǒ
ㄧㄛˋ	yò
˙ㄩㄥ	yong
ㄩㄥ	yōng
ㄩㄥˊ	yóng
ㄩㄥˇ	yǒng
ㄩㄥˋ	yòng
˙ㄧㄡ	you
ㄧㄡ	yōu
ㄧㄡˊ	yóu
ㄧㄡˇ	yǒu
ㄧㄡˋ	yòu
˙ㄩ	yu
ㄩ	yū
ㄩˊ	yú
ㄩˇ	yǔ
ㄩˋ	yù
˙ㄩㄢ	yuan
ㄩㄢ	yuān
ㄩㄢˊ	yuán
ㄩㄢˇ	yuǎn
ㄩㄢˋ	yuàn
˙ㄩㄝ	yue
ㄩㄝ	yuē
ㄩㄝˊ	yué
ㄩㄝˇ	yuě
ㄩㄝˋ	yuè
˙ㄩㄣ	yun
ㄩㄣ	yūn
ㄩㄣˊ	yún
ㄩㄣˇ	yǔn
ㄩㄣˋ	yùn
˙ㄗㄚ	za
ㄗㄚ	zā
ㄗㄚˊ	zá
ㄗㄚˇ	zǎ
ㄗㄚˋ	zà
˙ㄗㄞ	zai
ㄗㄞ	zāi
ㄗㄞˊ	zái
ㄗㄞˇ	zǎi
ㄗㄞˋ	zài
˙ㄗㄢ	zan
ㄗㄢ	zān
ㄗㄢˊ	zán
ㄗㄢˇ	zǎn
ㄗㄢˋ	zàn
˙ㄗㄤ	zang
ㄗㄤ	zāng
ㄗㄤˊ	záng
ㄗㄤˇ	zǎng
ㄗㄤˋ	zàng
˙ㄗㄠ	zao
ㄗㄠ	zāo
ㄗㄠˊ	záo
ㄗㄠˇ	zǎo
ㄗㄠˋ	zào
˙ㄗㄜ	ze
ㄗㄜ	zē
ㄗㄜˊ	zé
ㄗㄜˇ	zě
ㄗㄜˋ	zè
˙ㄗㄟ	zei
ㄗㄟ	zēi
ㄗㄟˊ	zéi
ㄗㄟˇ	zěi
ㄗㄟˋ	zèi
˙ㄗㄣ	zen
ㄗㄣ	zēn
ㄗㄣˊ	zén
ㄗㄣˇ	zěn
ㄗㄣˋ	zèn
˙ㄗㄥ	zeng
ㄗㄥ	zēng
ㄗㄥˊ	zéng
ㄗㄥˇ	zěng
ㄗㄥˋ	zèng
˙ㄓㄚ	zha
ㄓㄚ	zhā
ㄓㄚˊ	zhá
ㄓㄚˇ	zhǎ
ㄓㄚˋ	zhà
˙ㄓㄞ	zhai
ㄓㄞ	zhāi
ㄓㄞˊ	zhái
ㄓㄞˇ	zhǎi
ㄓㄞˋ	zhài
˙ㄓㄢ	zhan
ㄓㄢ	zhān
ㄓㄢˊ	zhán
ㄓㄢˇ	zhǎn
ㄓㄢˋ	zhàn
˙ㄓㄤ	zhang
ㄓㄤ	zhāng
ㄓㄤˊ	zháng
ㄓㄤˇ	zhǎng
ㄓㄤˋ	zhàng
˙ㄓㄠ	zhao
ㄓㄠ	zhāo
ㄓㄠˊ	zháo
ㄓㄠˇ	zhǎo
ㄓㄠˋ	zhào
˙ㄓㄜ	zhe
ㄓㄜ	zhē
ㄓㄜˊ	zhé
ㄓㄜˇ	zhě
ㄓㄜˋ	zhè
˙ㄓㄣ	zhen
ㄓㄣ	zhēn
ㄓㄣˊ	zhén
ㄓㄣˇ	zhěn
ㄓㄣˋ	zhèn
˙ㄓㄥ	zheng
ㄓㄥ	zhēng
ㄓㄥˊ	zhéng
ㄓㄥˇ	zhěng
ㄓㄥˋ	zhèng
˙ㄓ	zhi
ㄓ	zhī
ㄓˊ	zhí
ㄓˇ	zhǐ
ㄓˋ	zhì
˙ㄓㄨㄥ	zhong
ㄓㄨㄥ	zhōng
ㄓㄨㄥˊ	zhóng
ㄓㄨㄥˇ	zhǒng
ㄓㄨㄥˋ	zhòng
˙ㄓㄡ	zhou
ㄓㄡ	zhōu
ㄓㄡˊ	zhóu
ㄓㄡˇ	zhǒu
ㄓㄡˋ	zhòu
˙ㄓㄨ	zhu
ㄓㄨ	zhū
ㄓㄨˊ	zhú
ㄓㄨˇ	zhǔ
ㄓㄨˋ	zhù
˙ㄓㄨㄚ	zhua
ㄓㄨㄚ	zhuā
ㄓㄨㄚˊ	zhuá
ㄓㄨㄚˇ	zhuǎ
ㄓㄨㄚˋ	zhuà
˙ㄓㄨㄞ	zhuai
ㄓㄨㄞ	zhuāi
ㄓㄨㄞˊ	zhuái
ㄓㄨㄞˇ	zhuǎi
ㄓㄨㄞˋ	zhuài
˙ㄓㄨㄢ	zhuan
ㄓㄨㄢ	zhuān
ㄓㄨㄢˊ	zhuán
ㄓㄨㄢˇ	zhuǎn
ㄓㄨㄢˋ	zhuàn
˙ㄓㄨㄤ	zhuang
ㄓㄨㄤ	zhuāng
ㄓㄨㄤˊ	zhuáng
ㄓㄨㄤˇ	zhuǎng
ㄓㄨㄤˋ	zhuàng
˙ㄓㄨㄟ	zhui
ㄓㄨㄟ	zhuī
ㄓㄨㄟˊ	zhuí
ㄓㄨㄟˇ	zhuǐ
ㄓㄨㄟˋ	zhuì
˙ㄓㄨㄣ	zhun
ㄓㄨㄣ	zhūn
ㄓㄨㄣˊ	zhún
ㄓㄨㄣˇ	zhǔn
ㄓㄨㄣˋ	zhùn
˙ㄓㄨㄛ	zhuo
ㄓㄨㄛ	zhuō
ㄓㄨㄛˊ	zhuó
ㄓㄨㄛˇ	zhuǒ
ㄓㄨㄛˋ	zhuò
˙ㄗ	zi
ㄗ	zī
ㄗˊ	zí
ㄗˇ	zǐ
ㄗˋ	zì
˙ㄗㄨㄥ	zong
ㄗㄨㄥ	zōng
ㄗㄨㄥˊ	zóng
ㄗㄨㄥˇ	zǒng
ㄗㄨㄥˋ	zòng
˙ㄗㄡ	zou
ㄗㄡ	zōu
ㄗㄡˊ	zóu
ㄗㄡˇ	zǒu
ㄗㄡˋ	zòu
˙ㄗㄨ	zu
ㄗㄨ	zū
ㄗㄨˊ	zú
ㄗㄨˇ	zǔ
ㄗㄨˋ	zù
˙ㄗㄨㄢ	zuan
ㄗㄨㄢ	zuān
ㄗㄨㄢˊ	zuán
ㄗㄨㄢˇ	zuǎn
ㄗㄨㄢˋ	zuàn
˙ㄗㄨㄟ	zui
ㄗㄨㄟ	zuī
ㄗㄨㄟˊ	zuí
ㄗㄨㄟˇ	zuǐ
ㄗㄨㄟˋ	zuì
˙ㄗㄨㄣ	zun
ㄗㄨㄣ	zūn
ㄗㄨㄣˊ	zún
ㄗㄨㄣˇ	zǔn
ㄗㄨㄣˋ	zùn
˙ㄗㄨㄛ	zuo
ㄗㄨㄛ	zuō
ㄗㄨㄛˊ	zuó
ㄗㄨㄛˇ	zuǒ
ㄗㄨㄛˋ	zuò